english|french
'beedy-eye' jones|« Beedy-eye » Jones
'beefy' burns|« Beefy » Burns
'betty' b.boppin|« Betty » B.Boppin
'birds-eye' jack|« Birds-Eye » Jack
'black-eye'|« Black-eye »
'currency' the alchemist|« Currency » L'Alchimiste
'eagle-eye' shultz|« Eagle-eye » Shultz
'gummy'|« Gummy »
'lecherous' lee|« Lecherous » Lee
'no fingers'|« No fingers »
'picarron' pete|« Picarron » Pete
'squawking' steve beanie|« Squawking » Steve Beanie
'sticky' sanders|« Sticky » Sanders
'the guns'|« The Guns »
'transmute' the alchemist|« Transmute » The Alchemist
1337sp34kr|1337sp34kr
1v1 tournament guide|Guide du tournoi 1v1
50% luke|50 % Luke?
? ? ? ?|? ? ?
a corpse|A corpse
a doubt|A Doubt
a floating table|Une table flottante
a pile of broken glass|Un tas de verre brisé
a'abla|A'abla
abbot langley|Abbé Langley
aberab|Aberab
aberrant spectre|Spectre aberrant
abhorrent spectre|Spectre abominable
abidor crank|Abidor Crank
abigaila|Abigaila
abigale|Abigale
abomination|Abomination
abyssal antibody|Anticorps abyssal
abyssal axon|Axon abyssal
abyssal demon|Démon abyssal
abyssal guardian|Gardien abyssal
abyssal leech|Sangsue abyssale
abyssal orphan|Orphelin abyssal
abyssal pathfinder|Explorateur abyssal
abyssal portal|Portail abyssal
abyssal protector|Protecteur abyssal
abyssal sire|Seigneur abyssal
abyssal walker|Marcheur abyssal
academic|Académique
acatzin|Acatzin
account guide|Guide du compte
account security tutor|Tutoriel sur la sécurité du compte
achietties|Achietties
achilka|Achilka
achtryn|Achtryn
acidic araxyte|Araxyte acide
acidic bloodveld|Bloodveld acide
acorn|Gland
adala|Adala
adamant dragon|Dragon adamantin
adamantite ore|Minerai d'adamantite
adrinus|Adrinus
adrius|Adrius
adventurer|Aventurier
adventurer ada|Aventurière Ada
adventurer jon|Aventurier Jon
advisor|Conseiller
advisor ghrim|Conseiller Ghrim
aemad|Aemad
aemilia|Aemilia
aeonisig raispher|Aeonisig Raispher
afflicted|Affligé
afrah|Afrah
aga|Aga
agelus|Agelus
aggie|Aggie
agile scarab|Scarabée agile
agile warrior|Guerrier agile
agility boss|Boss d'agilité
agility instructor|Instructeur d'agilité
agility trainer|Entraîneur d'agilité
agitated bees|Abeilles agitées
agmundi|Agmundi
agnar|Agnar
agrith naar|Agrith Naar
agrith-na-na|Agrith-Na-Na
ahab|Ahab
ahrim the blighted|Ahrim le Fléau
air elemental|Élémentaire d'air
air wizard|Sorcier de l'air
aisles|Allées
aivas|Aivas
ajjat|Ajjat
ak-haranu|Ak-Haranu
akkha|Akkha
akkha's phantom|Fantôme d'Akkha
akkha's shadow|Ombre d'Akkha
akrisae|Akrisae
akthanakos|Akthanakos
al kharid warrior|Guerrier d'Al Kharid
al shabim|Al Shabim
al the camel|Al le Chameau
alain|Alain
alan|Alan
alaxxi|Alaxxi
alba|Alba
albatross|Albatros
albino bat|Chauve-souris albinos
alchemical hydra|Hydre alchimique
alchemy guardian|Gardien de l'alchimie
alec kincade|Alec Kincade
aleck|Aleck
alek constantine|Alek Constantine
alexander|Alexander
alexandra|Alexandra
alexis|Alexis
alfonse the waiter|Alfonse le serveur
ali morrisane|Ali Morrisane
ali the barman|Ali le barman
ali the camel|Ali le chameau
ali the camel man|Ali le chamelier
ali the carter|Ali le charretier
ali the dyer|Ali le teinturier
ali the farmer|Ali le fermier
ali the guard|Ali le garde
ali the hag|Ali la sorcière
ali the kebab seller|Ali le vendeur de kebabs
ali the leaflet dropper|Ali le distributeur de tracts
ali the mayor|Ali le maire
ali the operator|Ali l'opérateur
ali the smith|Ali le forgeron
ali the snake charmer|Ali le charmeur de serpents
ali the tailor|Ali le tailleur
ali the tea seller|Ali le vendeur de thé
alice|Alice
alice the camel|Alice la chamelle
alina|Alina
allanna|Allanna
almera|Almera
alomone|Alomone
alpaca|Alpaga
alpaca cria|Bébé alpaga
alrena|Alrena
alrik|Alrik
alry the angler|Alry le pêcheur
altarkiz|Altarkiz
aluft gianne snr.|Aluft Gianne snr.
alvarg|Alvarg
alviss|Alviss
alwyn|Alwyn
alyssa|Alyssa
amascut|Amascut
ambassador alvijar|Ambassadeur Alvijar
ambassador ferrnook|Ambassadeur Ferrnook
ambassador gimblewap|Ambassadeur Gimblewap
ambassador spanfipple|Ambassadeur Spanfipple
amelia|Amelia
ameyalli|Ameyalli
amma|Amma
ammonite crab|Crabe ammonite
ammunition crate|Caisse de munitions
amos|Amos
amoxliatl|Amoxliatl
amrod|Amrod
amy|Amy
ana|Ana
ana in a barrel|Ana dans un tonneau
anaire|Anaire
ancestral glyph|Glyphe ancestral
ancient custodian|Ancien gardien
ancient ghost|Ancien fantôme
ancient guardian|Ancien gardien
ancient monkey|Ancien singe
ancient wizard|Ancien sorcier
ancient wyvern|Ancien wyvern
ancient zygomite|Ancien zygomite
andiess juip|Andiess Juip
andras|Andras
andrea|Andrea
andros mai|Andros Mai
aneirin|Aneirin
angel|Ange
angelo|Angelo
angry barbarian spirit|Esprit barbare en colère
angry bear|Ours en colère
angry giant rat|Rat géant en colère
angry goblin|Gobelin en colère
angry tortugan|Tortugan en colère
angry unicorn|Licorne en colère
animated adamant armour|Armure adamantine animée
animated black armour|Armure noire animée
animated bronze armour|Armure de bronze animée
animated egg|Œuf animé
animated iron armour|Armure de fer animée
animated mithril armour|Armure de mithril animée
animated rune armour|Armure runique animée
animated spade|Pelle animée
animated steel armour|Armure d'acier animée
anita|Anita
anja|Anja
ankou|Ankou
anleif|Anleif
anna|Anna
anna jones|Anna Jones
anne|Anne
anne isaakson|Anne Isaakson
annette|Annette
annie|Annie
anteater|Fourmilier
anti-santa|Anti-Père Noël
anton|Anton
antonia|Antonia
antonius|Antonius
antos|Antos
anwen|Anwen
apmeken|Apmeken
apothecary|Apothicaire
apparition|Apparition
apprentice|Apprenti
apprentice cordelia|Apprenti Cordelia
apprentice felix|Apprenti Felix
apprentice tamara|Apprenti Tamara
apprentice workman|Apprenti ouvrier
aquanite|Aquanite
arancini|Arancini
aranwe|Aranwe
araxxor|Araxxor
araxyte|Araxyte
arc test|Test d'arc
arcane scarab|Scarabée arcanique
archeio|Archeio
archer|Archer
archibald|Archibald
archmage sedridor|Archimage Sedridor
archpriest of the unicorn|Grand prêtre de la Licorne
arcis|Arcis
arcuani|Arcuani
aredhel|Aredhel
arena guard beni|Garde de l'arène Beni
arena guard drakno|Garde de l'arène Drakno
arena guard fawry|Garde de l'arène Fawry
arena guard fronk|Garde de l'arène Fronk
arena guard joby|Garde de l'arène Joby
arena guard nikkolas|Garde de l'arène Nikkolas
arena guard rachi|Garde de l'arène Rachi
arena guard yon|Garde de l'arène Yon
aretha|Aretha
argenthorg|Argenthorg
argo|Argo
arhein|Arhein
arianwyn|Arianwyn
aris|Aris
aristarchus|Aristarchus
armadylean guard|Garde armadyléen
armod|Armod
armour salesman|Vendeur d'armures
armoured foe|Ennemi blindé
armoured kraken|Kraken blindé
armoured zombie|Zombie blindé
armourer|Armurier
army commander|Commandant de l'armée
arnkel|Arnkel
arno|Arno
arnold lydspor|Arnold Lydspor
arnor|Arnor
arrav|Arrav
arrg|Arrg
arsen the thief|Arsen le voleur
art|Art
art critic jacques|Critique d'art Jacques
arthur the clue hunter|Arthur le chasseur d'indices
artima|Artima
artimeus|Artimeus
artio|Artio
artur hosidius|Artur Hosidius
arvel|Arvel
arzinian avatar of magic|Avatar arzinien de la magie
arzinian avatar of ranging|Avatar arzinien du tir à distance
arzinian avatar of strength|Avatar arzinien de la force
arzinian being of bordanzan|Être arzinien de Bordanzan
asgarnia smith|Asgarnia Smith
ash|Ash
ashild|Ashild
ashuelot reis|Ashuelot Reis
askeladden|Askeladden
assassin|Assassin
assistant|Assistant
assistant brock|Assistant Brock
assistant le smith|Assistant Le Smith
assistant lori|Assistant Lori
assistant marrow|Assistant Marrow
assistant serf|Assistant Serf
assistant stan|Assistant Stan
asteros arceuus|Asteros Arceuus
asyff|Asyff
asyn shade|Asyn Shade
asyn shadow|Asyn shadow
atlas|Atlas
attala|Attala
atza|Atza
aub|Aub
aubury|Aubury
auctioneer|Commissaire-priseur
audmann|Audmann
auguste|Auguste
aurel|Aurel
aurelia|Aurelia
austri|Austri
autumn elemental|Élémentaire d'automne
ava|Ava
avan|Avan
avatar of creation|Avatar de la création
avatar of destruction|Avatar de la Destruction
aven|Aven
aviansie|Aviansie
avinia|Avinia
awakened altar|Autel éveillé
awowogei|Awowogei
awusah the mayor|Awusah, le maire
aya|Aya
ayesha|Ayesha
azzanadra|Azzanadra
ba-ba|Ba-Ba
ba-ba's phantom|Fantôme de Ba-Ba
baba yaga|Baba Yaga
baboon|Babouin
baboon brawler|Babouin bagarreur
baboon mage|Babouin mage
baboon shaman|Babouin chaman
baboon thrall|Babouin esclave
baboon thrower|Babouin lanceur
baby black dragon|Bébé dragon noir
baby blue dragon|Bébé dragon bleu
baby chinchompa|Bébé chinchompa
baby custodian stalker|Bébé gardien traqueur
baby green dragon|Bébé dragon vert
baby impling|Bébé impling
baby leviathan|Bébé léviathan
baby mole|Bébé taupe
baby red dragon|Bébé dragon rouge
baby roc|Bébé Roc
baby sea kraken|Bébé kraken marin
baby tanglefoot|Bébé tanglefoot
badger|Blaireau
bailey|Bailey
baker|Boulanger
bakuna|Bakuna
balance elemental|Élémentaire de l'équilibre Levele Magie
bald headed eagle|Aigle à tête chauve
balfrug kreeyath|Balfrug Kreeyath
ball boy|Garçon de balle Levele Midsummer
balloon animal|Animal en ballon Levele Chat
balloon toad|Crapaud en ballon
banana|Banane
bandit|Bandit
bandit champion|Champion bandit
bandit leader|Chef bandit
bandit shopkeeper|Commerçant bandit
bandosian guard|Garde bandosien
banisoch|Banisoch
bank buffalo|Buffle de banque
bank guard|Garde de banque
banker|Banquier
banker tutor|Tuteur banquier
banknote exchange merchant|Marchand changeur de billets
banshee|Banshee
baraek|Baraek sous la montagne de glace
barb|Barb
barb-tailed kebbit|Kebbit à queue barbue
barbara|Barbara
barbarian|Barbare
barbarian bartender|Barman barbare
barbarian guard|Garde barbare
barbarian warlord|Chef de guerre barbare
bard|Barde
bardur|Bardur
barfy bill|Barfy Bill
barge foreman|Contremaître de péniche
barge guard|Garde de péniche
barge workman|Ouvrier de péniche
bark blamish snail|Bark Blamish Snail
barker|Barker
barlak|Barlak
barmaid|Barmaid
barman|Barman
barnabus hurma|Barnabus Hurma
baron|Baron
barrelchest|Barrelchest
barricade|Barricade
bartak|Bartak
bartender|Barman
barus|Barus
basilisk|Basilic
basilisk knight|Chevalier basilic
basilisk sentinel|Sentinelle basilic
basilisk youngling|Jeune basilic
bast|Bast
bat|Chauve-souris
batt mellamy|Batt Mellamy
battle mage|Mage de combat
battle tortoise display|Tortue de combat
bear cub|Ourson
bearded gorilla|Gorille barbu
beaver|Castor
bedabin nomad|Nomade Bedabin
bedabin nomad fighter|Combattant nomade Bedabin
bedabin nomad guard|Garde nomade Bedabin
bedread the bold|Bedread l'audacieux
bee keeper|Apiculteur
bee swarm|Essaim d'abeilles
bees|Abeilles
bees!|Abeilles !
beggar|Mendiant
beigarth|Beigarth
beite|Beite
bella le bowle|Bella Le Bowle
belle|Belle
bellemorde|Bellemorde
belona|Belona
bench|Banc
benjamin|Benjamin
benny|Benny
bentamir|Bentamir
bernald|Bernald
bernard|Bernard
berry|Berry
berserk barbarian spirit|Esprit barbare berserk
bert|Bert
bethan|Bethan
betty|Betty
biblia|Biblia
big dave|Big Dave
big fish|Gros poisson
big frog|Big frog
big rat|Big rat
big snake|Big Snake
big wolf|Big Wolf
bigredjapan|BigRedJapan
biles|Biles
bill|Bill
bill teach|Bill Teach
billam|Billam
billy|Billy
billy goat|Billy Goat
billy rehnison|Billy Rehnison
billy, a guard of falador|Billy, un garde de Falador
bird|Oiseau
bjorn|Bjorn
black bear|Ours noir
black cat|Chat noir
black chinchompa|Chinchompa noir
black demon|Démon noir
black dragon|Dragon noir
black eye bethel|Œil au beurre noir Bethel
black golem|Golem noir
black guard|Garde noir
black guard berserker|Garde noir berserker
black heather|Bruyère noire
black jaguar|Jaguar noir
black knight|Chevalier noir
black knight captain|Capitaine chevalier noir
black knight titan|Chevalier noir titan
black salamander|Salamandre noire
black swan|Cygne noir
black unicorn|Licorne noire
black unicorn foal|Poulain licorne noire
black warlock|Sorcier noir
blackjack seller|Vendeur de blackjack
blacksmith|Forgeron
blaec|Blaec
blair|Blair
blandebir|Blandebir
blanin|Blanin
blasidar the sculptor|Blasidar le sculpteur
blast furnace foreman|Contremaître du haut fourneau
blasted ore|Minerai explosé
blenny|Blenny
blessed giant rat|Rat géant béni Levele 1
blessed spider|Araignée bénie Levele Normal
blood blamish snail|Escargot sanglant
blood cloud|Nuage de sang
blood jaguar|Jaguar sanglant
blood moon|Lune de sang
blood reaver|Reaper sanglant
blood spawn|Progeniture sanglante
blood totem|Totem sanglant
bloodhound|Chien de sang
bloodthirst rockslug|Limace sanguinaire
bloodthirsty abomination|Abomination sanguinaire
bloodthirsty abyssal demon|Démon abyssal sanguinaire
bloodthirsty banshee|Banshee sanguinaire
bloodthirsty basilisk|Basilic sanguinaire
bloodthirsty basilisk sentinel|Sentinelle basilisk sanguinaire
bloodthirsty bloodveld|Bloodveld sanguinaire
bloodthirsty choke devil|Démon sanguinaire
bloodthirsty cockathrice|Cockathrice sanguinaire
bloodthirsty crawler|Rampeur sanguinaire
bloodthirsty drake|Drake sanguinaire
bloodthirsty gargoyle|Gargouille sanguinaire
bloodthirsty hand|Main sanguinaire
bloodthirsty hydra|Hydre sanguinaire
bloodthirsty infernal pyrelord|Seigneur pyre infernal sanguinaire
bloodthirsty jelly|Gelée sanguinaire
bloodthirsty kurask|Kurask sanguinaire
bloodthirsty mage|Mage sanguinaire
bloodthirsty mutated bloodveld|Bloodveld muté sanguinaire
bloodthirsty nechryarch|Nechryarch sanguinaire
bloodthirsty night beast|Bête nocturne sanguinaire
bloodthirsty pyrelord|Seigneur des flammes sanguinaire
bloodthirsty repugnant spectre|Spectre répugnant sanguinaire
bloodthirsty shadow wyrm|Wyrm de l'ombre sanguinaire
bloodthirsty smoke devil|Démon de fumée sanguinaire
bloodthirsty spectre|Spectre sanguinaire
bloodthirsty turoth|Turoth sanguinaire
bloodthirsty twisted banshee|Banshee tordue sanguinaire
bloodthirsty warped jelly|Gelée déformée sanguinaire
bloodveld|Bloodveld
bloodworm|Bloodworm
bloody wave|Vague sanglante
blue crab|Crabe bleu
blue dagannoth|Dagannoth bleu
blue dragon|Dragon bleu
blue h'ween mask|Masque bleu d'Halloween
blue monkey|Singe bleu
blue moon|Lune bleue
blue opal director|Directeur Blue Opal
blue opal secretary|Secrétaire Blue Opal
blue partyhat|Chapeau de fête bleu
blue sheep|Mouton bleu
blurberry|Blurberry
boar|Sanglier Levele 5
boar31337killer|Sanglier 31337Killer
boat|Bateau
bob|Bob
bob barter|Bob Barter
bob, another guard of falador|Bob, un autre garde de Falador
bobawu|Bobawu
bobbing fossil|Fossile flottant
bobby|Bobby
body golem|Golem corporel
bolkoy|Bolkoy
bologa|Bologa
bolongo|Bolongo
bonafido|Bonafido
boneguard|Boneguard
bones|Bones
bonzara|Bonzara
bonzo|Bonzo
boot|Boot
border guard|Garde-frontière
boris|Boris
bork sigmundson|Bork Sigmundson
borrokar|Borrokar
bosun zarah|Bosun Zarah
boulder|Roche
bouncer|Videur
bouquet mac hyacinth|Bouquet Mac Hyacinth
bow and arrow salesman|Vendeur d'arcs et de flèches
bowley moley|Bowley Moley
boy|Garçon
brain|Cerveau
brambickle|Brambickle
bran|Bran
brana|Brana
branda the fire queen|Branda, la reine du feu
branwen|Branwen
brass hand harry|Brass Hand Harry
brassican mage|Mage brassican
bravek|Bravek
brawler|Brawler
bree|Bree
breive|Breive
brendt|Brendt
breoca|Breoca
brew'ma|Brew'ma
brewer|Brewer
brian|Brian
brian o'richard|Brian O'Richard
briget|Briget
brikka|Brikka
brimstail|Brimstail
brine rat|Rat des marais
broav|Broav
broddi|Broddi
broken handz|Broken Handz
bronze dragon|Dragon de bronze
bronze eagle|Aigle de bronze
broodoo victim|Victime de Broodoo
brother aimeri|Frère Aimeri
brother althric|Frère Althric
brother brace|Frère Brace
brother cedric|Frère Cedric
brother jered|Frère Jered
brother kojo|Frère Kojo
brother maledict|Frère Maledict
brother omad|Frère Omad
brother tranquility|Frère Tranquility
brown engine director|Directeur Brown Engine
brown engine secretary|Secrétaire Brown Engine
brownie|Brownie
brugsen bursen|Brugsen Bursen
bruise blamish snail|Bruise Blamish Snail
brundt|Brundt
brundt the chieftain|Brundt le chef de tribu
brutal black dragon|Dragon noir brutal
brutal blue dragon|Dragon bleu brutal
brutal green dragon|Dragon vert brutal
brutal red dragon|Dragon rouge brutal
bryn|Bryn
bryophyta|Bryophyta
buffalo|Buffle
buffalo spirit|Esprit du buffle
bugs|Insectes
builder|Constructeur
buinn|Buinn
bull shark|Requin taureau
buneir|Buneir
bunkdo|Bunkdo
bunkwicket|Bunkwicket
bunny|Lapin Levele 1
bunny ears|Oreilles de lapin
buoy|Bouée
burkor|Burkor
burning orb|Orbe brûlant
burntmeat|Viande brûlée
burntof|Burntof
bush snake|Serpent des buissons
butch|Butch
butler|Majordome
butler jarvis|Majordome Jarvis
butler jones|Majordome Jones
butterfly|Papillon
butterfly ray|Raie papillon
c0lect0r890|C0lect0r890
c4ssi4n|C4ssi4n
cabbage farmer|Cultivateur de choux
cabin boy|Mousse
cabin boy colin|Mousse Colin
cabin boy herbert|Mousse Herbert
cabin boy jenkins|Mousse Jenkins
cabin boy percy|Mousse Percy
caden azro|Caden Azro
caerwyn|Caerwyn
caique|Caique
caius|Caius
caleb|Caleb
calin|Calin
callio|Callio
callisto|Callisto
callisto cub|Callisto cub
calvar'ion|Calvar'ion
cam the camel|Cam le chameau
camarst|Camarst
camel|Chameau
camel display|Exposition de chameaux
camorra|Camorra
camp dweller|Habitant du camp
candle maker|Fabricant de bougies
candle seller|Vendeur de bougies
caninelle draynar|Caninelle Draynar
cannoneer|Canonnier
canyoucratchit|CanYouCratchit
cap'n anne boney|Capitaine Anne Boney
cap'n hand|Capitaine Hand
cap'n izzy no-beard|Capitaine Izzy No-Beard
capt' arnav|Capitaine Arnav
captain|Capitaine
captain ada|Capitaine Ada
captain ariadna|Capitaine Ariadna
captain barnaby|Capitaine Barnaby
captain bentley|Capitaine Bentley
captain bleemadge|Capitaine Bleemadge
captain braindeath|Capitaine Braindeath
captain bruce|Capitaine Bruce
captain cain|Capitaine Cain
captain campbell|Capitaine Campbell
captain cleive|Capitaine Cleive
captain cotus|Capitaine Cotus
captain daerkin|Capitaine Daerkin
captain dalbur|Capitaine Dalbur
captain darvald|Capitaine Darvald
captain dawson|Capitaine Dawson
captain donnie|Capitaine Donnie
captain dudi|Capitaine Dudi
captain emmemji|Capitaine Emmemji
captain errdo|Capitaine Errdo
captain ginea|Capitaine Ginea
captain janaway|Capitaine Janaway
captain jim|Capitaine Jim
captain kalt|Capitaine Kalt
captain khaled|Capitaine Khaled
captain klemfoodle|Capitaine Klemfoodle
captain lamdoo|Capitaine Lamdoo
captain lawgof|Capitaine Lawgof
captain maclean|Capitaine Maclean
captain magoro|Capitaine Magoro
captain malleta|Capitaine Malleta
captain ninto|Capitaine Ninto
captain pudi|Capitaine Pudi
captain rachelle|Capitaine Rachelle
captain reuben|Capitaine Reuben
captain rimor|Capitaine Rimor
captain rovin|Capitaine Rovin
captain sdiar|Capitaine Sdiar
captain shanks|Capitaine Shanks
captain shoracks|Capitaine Shoracks
captain siad|Capitaine Siad
captain tobias|Capitaine Tobias
captain tock|Capitaine Tock
captain tom|Capitaine Tom
captain vibia|Capitaine Vibia
capybara|Capybara
capybara pup|Bébé capybara
carado|Carado
caranthir|Caranthir
caritta|Caritta
carl|Carl
carla|Carla
carnivorous chinchompa|Chinchompa carnivore
carnivus belamorta|Carnivus Belamorta
carol|Carol
caroline|Caroline
carpenter|Charpentier
carpenter kjallak|Charpentier Kjallak
cart camel|Chameau de charrette
cart conductor|Conducteur de chariot
cassie|Cassie
cassim|Cassim
cassius|Cassius
castaway|Naufragé Levele 1, chien, à la dérive
cat|Chat
catablepon|Catablepon
catalina|Catalina
catalyst|Catalyseur
catalytic guardian|Gardien catalytique
catherby monodon|Monodon de Catherby
cave abomination|Abomination des cavernes
cave bug|Insecte des cavernes
cave bug larva|Larve d'insecte des cavernes
cave crawler|Rampeur des cavernes
cave goblin|Gobelin des cavernes
cave goblin child|Enfant gobelin des cavernes
cave goblin guard|Garde gobelin des cavernes
cave goblin miner|Mineur gobelin des cavernes
cave goblin worker|Ouvrier gobelin des cavernes
cave horror|Horreur des cavernes Levele Alpha
cave kraken|Kraken des cavernes Levele Kraken des cavernes
cave lizard|Lézard des cavernes
cave monk|Moine des cavernes
cave scenery|Paysage de grotte
cave slime|Slime des cavernes
cave snake|Serpent des cavernes
cavemouth|Cavemouth
cavey davey|Cavey Davey
cecilia|Cecilia
celebrian|Celebrian
celegorm|Celegorm
celyn|Celyn
centaur|Centaure Levele Femme
ceolburg|Ceolburg
cerberus|Cerberus
cerebral pathbreaker|Pionnier cérébral
cerebral pathfinder|Explorateur cérébral
ceril carnillean|Ceril Carnillean
cerulean twitch|Cerulean twitch
ceto|Ceto
chadwell|Chadwell
chaeldar|Chaeldar
chair|Chaise
chamber guardian|Gardien de la chambre
chameleon|Caméléon
champion of scabaras|Champion de Scabaras
chancellor hassan|Chancelier Hassan
chancy|Chancy
chaos druid|Druide du chaos
chaos druid warrior|Guerrier druide du chaos
chaos dwarf|Nain du chaos
chaos elemental|Élémentaire du chaos
chaos fanatic|Fanatique du chaos
chaos golem|Golem du chaos
chaotic death spawn|Progeniture de la mort chaotique
charles|Charles
charles charlington|Charles Charlington
charles charlington ii|Charles Charlington II
charley|Charley
charlie|Charlie
charlie the cook|Charlie le cuisinier
charlie the tramp|Charlie le clochard
charliechimes06|CharlieChimes06
charmed warrior|Guerrier enchanté
chartin' charles mcatless|Chartin' Charles McAtless
chasm crawler|Chasm Crawler
checkal|Checkal
cheerleader|Pom-pom girl
chef|Chef
chef olivia|Chef Olivia
chemist|Chimiste
cheryl|Cheryl
chet|Chet
chicken|Poulet
chicken suit|Costume de poulet
chief engineer greyson|Ingénieur en chef Greyson
chief servant|Serviteur en chef
chief tess|Chef Tess
child|Enfant
chilled jelly|Gelée glacée
chimalli|Chimalli
chinchompa|Chinchompa
chinchompa chum|Chinchompa chum
chiribaya|Chiribaya Levele 1
choke devil|Choke devil
chompy bird|Chompy bird
chompy chick|Chompy chick
chosen aluinus|Chosen Aluinus
chouani|Chouani
chris|Chris
christina kebbit-monkfish|Christina Kebbit-Monkfish
christmas cracker|Christmas cracker
chronozon|Chronozon
chuck|Chuck
chuck up|Chuck up
cirdan|Cirdan
citizen|Citoyen
citlalli|Citlalli
city guard|Garde municipal
civilian|Civil Levele 1
clan guard|Garde du clan
clanila|Clanila
clarence|Clarence
claude|Claude
claus the chef|Claus le chef cuisinier
clay golem|Golem d'argile
cleaner|Nettoyeur
cleddyf|Cleddyf
clerk|Commis
clerris|Clerris
clivet|Clivet
clodius|Clodius
clothears|Clothears
clue turtle|Clue turtle
co-ordinator|Co-ordinator
coal|Coal
cob|Cob
cobado|Cobado
cochu|Cochu
cockathrice|Cockathrice
cockatrice|Cockatrice
cockroach|Cockroach
cocktail seller|Vendeur de cocktails
coenus|Coenus
col. o'niall|Col. O'Niall
colonel grimsson|Colonel Grimsson
colonel radick|Colonel Radick
colossal chocco chicken|Poulet Chocco colossal
colossal hydra|Hydre colossale
colosseum announcer|Annonceur du Colisée
combat dummy|Mannequin d'entraînement
combat stone|Pierre de combat
combat test|Test de combat Levele 1 Coup maximal
commander|Commandant
commander connad|Commandant Connad
commander fullore|Commandant Fullore
commander montai|Commandant Montai
commander veldaban|Commandant Veldaban
commander zilyana|Commandant Zilyana
commissioner anwar|Commissaire Anwar
competition judge|Juge de compétition
conara|Conara
concerned man|Homme inquiet
confused barbarian|Barbare confus
confusion beast|Bête de la confusion
conrad king|Conrad King
constantinius|Constantinius
construction worker|Ouvrier du bâtiment
conwenna|Conwenna
cook|Cuisinier
cooking tutor|Professeur de cuisine
cooky weasel|Cooky Weasel
cool mom227|Cool Mom227
copper longtail|Queue longue en cuivre
copper ore|Minerai de cuivre
core|Noyau
corkat quo sihar|Corkat quo Sihar
cormorant|Cormoran
cornelius|Cornelius
corporeal beast|Bête corporelle
corpse|Cadavre
corrupt lizardman|Hommes-lézards corrompus
corrupted bat|Chauve-souris corrompue
corrupted bear|Ours corrompu
corrupted dark beast|Bête noire corrompue
corrupted dragon|Dragon corrompu
corrupted hunllef|Hunllef corrompu
corrupted rat|Rat corrompu
corrupted scavenger|Charognard corrompu
corrupted scorpion|Scorpion corrompu
corrupted spider|Araignée corrompue
corrupted unicorn|Licorne corrompue
corrupted warrior|Guerrier corrompu
corrupted wolf|Loup corrompu
corsair traitor|Traître corsaire
cosmic being|Être cosmique
costumed child|Enfant déguisé
costumer|Costumier
council workman|Ouvrier du conseil
councillor andrews|Conseiller Andrews
councillor catherine|Conseillère Catherine
councillor halgrive|Conseiller Halgrive
councillor orson|Conseiller Orson
councillor unkar|Conseiller Unkar
count check|Comte Check
count draynor|Comte Draynor
court judge|Juge
cow|Vache
cow calf|Veau
cow31337killer|Vache31337Killer
cowardly bandit|Bandit lâche
cozyac|Cozyac
crab|Crabe
crafting tutor|Tuteur d'artisanat
crandor shark|Requin de Crandor
crate|Caisse
crate goblin|Gobelin des caisses
crawling hand|Main rampante
crazy archaeologist|Archéologue fou
creakyknees|Creakyknees
crefydd|Crefydd
crew registrar|Registreur d'équipage
crimson sanguisphera|Sanguisphera cramoisie
crimson swift|Swift cramoisi
crimsonette van marr|Crimsonette van Marr
crocodile|Crocodile
crondis|Crondis
crone|Vieille sorcière
crow|Corbeau
crunchy|Crunchy
cruor|Cruor
crusher|Broyeur
crushing hand|Main écrasante
crust of ice|Croûte de glace
crypt rat|Rat des cryptes
crypt spider|Araignée des cryptes
crystal impling|Impling de cristal
crystal whirlwind|Tourbillon de cristal
crystalline bat|Chauve-souris cristalline
crystalline bear|Ours cristallin
crystalline dark beast|Bête noire cristalline
crystalline dragon|Dragon cristallin
crystalline hunllef|Hunllef cristallin
crystalline rat|Rat cristallin
crystalline scorpion|Scorpion cristallin
crystalline spider|Araignée cristalline
crystalline unicorn|Licorne cristalline
crystalline wolf|Loup cristallin
crystallised helm|Casque cristallisé
cuali, teoki of ralos|Cuali, Teoki de Ralos
cuffs|Menottes
cuica|Cuica
culinaromancer|Culinaromancer
cultist|Cultiste Levele 1
curator haig halen|Conservateur Haig Halen
curator herminius|Conservateur Herminius
curly|Curly
curpile fyod|Curpile Fyod
current duck|Canard actuel
cursed baboon|Babouin maudit
curufin|Curufin
customer|Client
customs officer|Douanier
cute creature|Créature mignonne
cuthbert|Cuthbert
cyclops|Cyclope
cyreg paddlehorn|Cyreg Paddlehorn
cyrisus|Cyrisus
d3ad1i f15her|D3ad1i F15her
da vinci|Da Vinci
dad|Dad
daddy's special water|L'eau spéciale de papa
daer krand|Daer Krand
daero|Daero
daga|Daga
dagannoth|Dagannoth
dagannoth fledgeling|Dagannoth novice
dagannoth mother|Dagannoth mère
dagannoth prime|Dagannoth Prime
dagannoth rex|Dagannoth Rex
dagannoth spawn|Dagannoth spawn
dagannoth supreme|Dagannoth suprême
dakh'thoulan aegis|Dakh'thoulan Aegis
dalal|Dalal
dalcian fang|Dalcian Fang
dale|Dale
dalila|Dalila
dallas jones|Dallas Jones
dalldav|Dalldav
dalna|Dalna
damien leucurte|Damien Leucurte
damis|Damis
dampe|Dampe
damwin|Damwin
dantaera|Dantaera
darcor quo narga|Darcor quo Narga
dark ankou|Dark Ankou
dark beast|Dark beast
dark energy core|Dark energy core
dark kebbit|Dark kebbit
dark mage|Dark Mage
dark squall|Dark Squall
dark warrior|Dark warrior
dark wizard|Sorcier noir
darkmeyer slave|Esclave de Darkmeyer
darren|Darren
dartog|Dartog
darve|Darve
daryl|Daryl
dashing kebbit|Kebbit fringant
dave|Dave
davey|Davey
david|David
davon|Davon
dawn|Aube
dead monk|Moine mort
dead wolf|Loup mort
deadly red spider|Araignée rouge mortelle
death|Mort
death spawn|Apparition de la mort
death wing|Aile de la mort
deathly mage|Mage mortel
deathly ranger|Ranger mortel
deathlyfuture3|DeathlyFuture3
debra|Debra
debug man|Debug Man
debug woman|Femme débogueuse
deckchair|Chaise longue
deep sea kraken|Kraken des profondeurs
defiler|Profanateur
definitely not dusk|Certainement pas le crépuscule
del-monty|Del-Monty
delf|Delf
delrith|Delrith
demon|Démon
demon butler|Majordome démoniaque
demon of balance|Démon de l'équilibre
demon of darkness|Démon des ténèbres
demon of light|Démon de la lumière
demonic gorilla|Gorille démoniaque Levele 1
demonic larva|Larve démoniaque
denadu|Denadu
denath|Denath
denulth|Denulth
deranged archaeologist|Archéologue dérangé
derni|Derni
dernu|Dernu
derrik|Derrik
derse venator|Derse Venator
derwen|Derwen
desert eagle|Aigle du désert
desert lizard|Lézard du désert
desert phoenix|Phénix du désert
desert spirit|Esprit du désert
desert wolf|Loup du désert
desmodus lasiurus|Desmodus Lasiurus
despoina callidra|Despoina Callidra
dessourt|Dessourt
dessous|Dessous
devan rutter|Devan Rutter
deviant spectre|Spectre déviant
deviled dave|Dave le diabolique
devin mendelberg|Devin Mendelberg
dhalak|Dhalak
dharok the wretched|Dharok le misérable
diana|Diana
diango|Diango
dig site workman|Ouvrier du site de fouilles
digsite workman|Ouvrier du site de fouilles Levele 1
dimintheis|Dimintheis
dinky the drink troll|Dinky le troll buveur
diol|Diol
dipflip|Dipflip
diphylla bechstein|Diphylla Bechstein
dire gryphon|Gryphon féroce
dire wolf|Loup féroce
dire wolf alpha|Loup affamé Alpha
disappointed daughter|Fille déçue
disappointed father|Père déçu
disappointed mother|Mère déçue
disciple of iban|Disciple d'Iban
disciple of yama|Disciple de Yama
disk of returning|Disque du retour
dobwinkle|Dobwinkle
dock worker|Ouvrier du quai Levele 1
dockmaster|Dockmaster
doctor orbon|Doctor Orbon
dodgy geezer|Dodgy geezer
dodgy squire|Dodgy Squire
doe|Doe
dog|Dog
doll|Doll
dolph|Dolph
dolphin|Dolphin
dolphin calf|Dolphin calf
dom|Dom
dominic onion|Dominic Onion
dominicus, teoki of ranul|Dominicus, Teoki de Ranul
dommik|Dommik
don|Don
don't know what|Je ne sais pas quoi
donal|Donal
dondakan the dwarf|Dondakan le nain Levele Pas de pioche
donie|Donie
donny the lad|Donny le garçon
donovan the family handyman|Donovan le bricoleur de la famille
doom of mokhaiotl|Doom of Mokhaiotl
doom scorpion|Doom Scorpion
doomion|Doomion
doomsayer|Doomsayer
door guard|Door Guard
door man|Door man
door-support|Door-support
doria|Doria
doric|Doric
doris|Doris
double agent|Double agent
doug deeping|Doug Deeping
doughphie|Doughphie
doyen|Doyen
dr banikan|Dr Banikan
dr fenkenstrain|Dr Fenkenstrain
dr ford|Dr Ford
dr harlow|Dr Harlow
dr jekyll|Dr Jekyll
draconis sanguine|Draconis Sanguine
dragon display|Exposition de dragons
dragon egg|Œuf de dragon
dragon impling|Impling dragon
dragonkin|Dragonkin
drain pipe|Tuyau d'évacuation
drake|Drake
drasdan ranor|Drasdan Ranor
draul leptoc|Draul Leptoc
draven quillshade|Draven Quillshade
dreadborn araxyte|Dreadborn Araxyte
dreven|Dreven
drew|Drew
drezel|Drezel
driftwood|Driftwood
drill sergeant|Sergent instructeur
drink troll|Troll buveur
drink troll queen|Reine des trolls buveurs
droalak|Droalak
drogo dwarf|Nain Drogo
dromund|Dromund
dromund's cat|Chat de Dromund
dron|Dron
druid|Druide
druid spirit|Esprit druide
drunken ali|Ali l'ivrogne
drunken dwarf|Nain ivrogne
drunken dwarf's leg|Jambe de nain ivrogne
drunken man|Homme ivre
drunken soldier|Soldat ivre
dryad|Dryade
duck|Canard
duckling|Caneton
ducklings|Canetons
duel guide|Guide du duel
duelist|Duelliste
dugopul|Dugopul
duke|Duke
duke horacio|Duke Horacio
duke rabbacio|Duke Rabbacio
duke sucellus|Duc Sucellus
dumpy|Dumpy
dunce|Dunce
dung|Dung
dungeon rat|Rat des donjons
dunstan|Dunstan
duradel|Duradel
durgok|Durgok
durial321|Durial321
durrik|Durrik
dusk|Dusk
dust devil|Tourbillon de poussière
dusty aliv|Dusty Aliv
dusuri|Dusuri
dwarf|Nain
dwarf gang member|Membre du gang des nains
dwarven boatman|Bateau nain
dwarven engineer|Ingénieur nain
dwarven ferryman|Passeur nain
dwarven miner|Mineur nain
dylan|Dylan
eadburg|Eadburg
eadgar|Eadgar
eagle|Aigle
eagle ray|Raie aigle
eagle spirit|Esprit aigle
earth elemental|Élémentaire de terre
earth impling|Impling de terre
earth spell|Sort de terre
earth warrior|Guerrier de la terre
earth warrior champion|Champion guerrier de la terre
earth wizard|Sorcier de la terre
earthen nagua|Nagua de terre
earthen shield|Bouclier de terre
earwen|Earwen
easter bunny|Lapin de Pâques
easter duck|Canard de Pâques
easter egg|Œuf de Pâques
easter egg bird|Oiseau œuf de Pâques
easter ring|Anneau de Pâques
ebenezer1843|Ebenezer1843
eblis|Eblis
ecatl|Ecatl
eclectic impling|Impling éclectique
eclipse moon|Lune d'éclipse
ed|Ed
ed wood|Ed Wood
edmond|Edmond
edrahil|Edrahil
eduard|Eduard
edward|Edward
eebel|Eebel
eek|Eek
efa|Efa
effigy|Effigie
eg|Eg
egg|Œuf
egg launcher|Lanceur d'œufs
egg mine cart|Chariot à œufs
egg priest|Prêtre aux œufs
eggus manus|Eggus Manus
eggy|Eggy
ehecatl|Ehecatl
einar|Einar
eira|Eira
ek'ans chan|Ek'ans Chan
ektheme|Ektheme
eldalote|Eldalote
elder aquanite|Ancien aquanite
elder blunn|Ancien Blunn
elder chaos druid|Ancien druide du chaos
elder coco|Ancien Coco
elder custodian stalker|Ancien gardien traqueur
elder gnome child|Ancien enfant gnome
elder guard|Ancien garde
elder hubber|Ancien Hubber
elder katt|Ancien Katt
elder kelmo|Ancien Kelmo
elder korel|Ancien Korel
elder krill|Ancien Krill
elder nama|Ancien Nama
elder raley|Ancien Raley
elder reggle|Ancien Reggle
elder root|Ancien Root
elder strom|Ancien Strom
elder torgan|Ancien Torgan
eldgrim|Eldgrim
eldric the ice king|Eldric le roi des glaces
eleanor|Eleanor
elemental rock|Roche élémentaire
elena|Elena
elena hosidius|Elena Hosidius
elenwe|Elenwe
eleuia|Eleuia
elf archer|Archer elfe
elf tracker|Traqueur elfe
elf warrior|Guerrier elfe
elfinlocks|Elfinlocks
elgan|Elgan
elias white|Elias White
elidinis' warden|Gardien d'Elidinis
elijah|Elijah
elisabeta|Elisabeta
elise|Elise
elissa|Elissa
elite black knight|Chevalier noir d'élite
elite dark mage|Mage noir d'élite
elite dark ranger|Ranger noir d'élite
elite dark warrior|Guerrier noir d'élite
elite khazard guard|Garde Khazard d'élite
elite void knight|Chevalier du Vide d'élite
eliza|Eliza
elizabeth|Elizabeth
elkoy|Elkoy
elladan|Elladan
ellen|Ellen
ellena|Ellena
ellie|Ellie
ellis|Ellis
elly the camel|Elly la chamelle
elnes|Elnes
elnock inquisitor|Inquisiteur Elnock
elsie|Elsie
elson|Elson
elstan|Elstan
eluned|Eluned
elvarg|Elvarg
elven city guard|Garde de la cité elfique
elven scout|Éclaireur elfique
embalmer|Embaumeur
embertailed jerboa|Jerboa à queue de braise
emblem trader|Marchand d'emblèmes
emelio|Emelio
emem sharma|Emem Sharma
emerald benedict|Emerald Benedict
emilia|Emilia
emily|Emily
emissary acolyte|Émissaire acolyt
emissary archer|Archer émissaire Levele 1
emissary ascended|Émissaire ascensionné Levele 1
emissary brawler|Émissaire bagarreur Levele niveau 74
emissary chef|Émissaire chef
emissary chosen|Émissaire élu
emissary conjurer|Émissaire Conjureur Levele 1
emissary enforcer|Émissaire Exécuteur
emissary fisher|Émissaire Pêcheur
emissary forebearer|Précurseur émérite
emissary herder|Berger émérite
emma|Emma
enakhra|Enakhra Levele Cinématique
enchanted broom|Balai enchanté
enchanted bucket|Seau enchanté Levele 1
enchantment guardian|Gardien enchanté
enclave guard|Garde de l'enclave
enel|Enel
enelye|Enelye
enerdhil|Enerdhil
energy focus|Concentration d'énergie Levele 1
energy siphon|Siphon d'énergie
energy sprite|Sprite d'énergie
engineer|Ingénieur
engineering assistant|Assistant ingénieur Levele 1
enilly|Enilly
eniola|Eniola
ennius tullus|Ennius Tullus
enormous tentacle|Tentacule énorme
enraged barbarian spirit|Esprit barbare enragé
enraged boar|Sanglier enragé
ent|Ent
entling|Entling
entomologist|Entomologiste
entrana firebird|Oiseau de feu d'Entrana
entrance guardian|Gardien de l'entrée
eodan|Eodan
eohric|Eohric
eoin|Eoin
episcula helsing|Episcula Helsing
erasmus|Erasmus
ercos|Ercos
erdan|Erdan
erestor|Erestor
eric|Eric
ermin|Ermin
ernest|Ernest
erodoeht|Erodoeht
escaping slave|Esclave en fuite
essence impling|Essence impling
essyllt|Essyllt
estate agent|Agent immobilier
esther|Esther
ethereal being|Être éthéré
ethereal expert|Expert éthéré
ethereal fluke|Hasard éthéré
ethereal guide|Guide éthéré
ethereal lady|Dame éthérée
ethereal man|Homme éthéré
ethereal mimic|Mimique éthérée
ethereal numerator|Numérateur éthéré
ethereal perceptive|Perceptif éthéré
etz|Etz
eudav|Eudav
eve|Eve
evelot|Evelot
evil bob|Bob le maléfique
evil chicken|Poulet maléfique
evil creature|Créature maléfique
evil dave|Dave maléfique
evil spirit|Esprit maléfique
ewesey|Ewesey
ex-captain siad|Ex-capitaine Siad
examiner|Examinateur
executioner|Bourreau
experiment|Expérience
experiment no.2|Expérience Levele 2
eyatlalli|Eyatlalli
eye|Œil
ezco, teoki of ranul|Ezco, Teoki de Ranul
ezekial lovecraft|Ezekial Lovecraft
faaid|Faaid
fabia|Fabia
factory manager|Directeur d'usine
factory worker|Ouvrier d'usine Levele 1
fadli|Fadli
fairy|Fée
fairy aeryka|Fée Aeryka
fairy chef|Chef fée
fairy fixit|Fée Fixit
fairy godfather|Fée marraine
fairy nuff|Fée Nuff
fairy queen|Reine des fées
fairy shop assistant|Vendeuse fée
fairy shop keeper|Propriétaire de boutique fée
fairy very wise|Fée très sage
fake man|Faux homme
falo the bard|Falo le barde
famished shark|Requin affamé
fancy dan|Fancy Dan
fanellaman|Fanellaman
fareed|Fareed
farid morrisane|Farid Morrisane
farmer|Fermier
farmer brumty|Fermier Brumty
farmer fromund|Fermier Fromund
farmer gricoller|Fermier Gricoller
farmer hayfield|Fermier Hayfield
farmer maggot|Fermier Maggot
farolt|Farolt
fat rocco|Fat Rocco
fat tony|Fat Tony
father aereck|Père Aereck
father badden|Père Badden
father buckerek|Père Buckerek
father eysseric|Père Eysseric
father gnome|Père Gnome
father jean|Père Jean
father lawrence|Père Lawrence
father reen|Père Reen
father urhney|Père Urhney
faustus|Faustus
fayeth|Fayeth
feanor|Feanor
fear reaper|Fear reaper
felfiz yaryus|Felfiz Yaryus
felius|Felius
felix|Felix
felkrash|Felkrash
female amur leopard|Femelle léopard d'Amour
female lion|Femelle lion
female slave|Esclave féminine
female snow leopard|Femelle léopard des neiges
female tiger|Femelle tigre
femi|Femi
fennec fox|Renard fennec
fennec fox cub|Petit renard fennec
fenric hollowspire|Fenric Hollowspire
ferain|Ferain
feral vampyre|Vampire sauvage
ferd|Ferd
fernahei|Fernahei
ferocious barbarian spirit|Esprit barbare féroce
ferox|Ferox
ferret|Furet
ferryman nathwood|Passeur Nathwood
ferryman sathwood|Passeur Sathwood
festive cook|Cuisinier festif
fever spider|Araignée fiévreuse
ffoni|Ffoni
fidelio|Fidelio
fighter|Combattant
filamina|Filamina
filliman tarlock|Filliman Tarlock
financial seer|Voyant financier
financial wizard|Sorcier financier
finarfin|Finarfin
findis|Findis
finduilas|Finduilas
fingolfin|Fingolfin
fingon|Fingon
finn|Finn
fionella|Fionella
fior|Fior
fiora|Fiora
fire|Feu
fire elemental|Élémentaire de feu
fire giant|Géant de feu
fire spell|Sort de feu
fire warrior of lesarkus|Guerrier de feu de Lesarkus
fire wave|Vague de feu
fire wizard|Sorcier de feu
first mate 'davey-boy'|Premier lieutenant « Davey-boy »
first mate deri|Premier lieutenant Deri
first mate peri|Premier lieutenant Peri
fish|Poisson
fish monger|Poissonnier
fish shoal|Banc de poissons
fishbowl|Bocal à poissons
fisher|Pêcheur Levele 1
fisherman|Pêcheur
fisherman frodi|Pêcheur Frodi
fishing spot|Lieu de pêche
fishing tutor|Tuteur de pêche
fishmonger|Poissonnier
fishrunner82|Fishrunner82
fiyr shade|Fiyr Shade
flambeed|Flambeed
flaming pyrelord|Flaming pyrelord
flawed golem|Golem imparfait
flax keeper|Gardien du lin
flaygian screwte|Flaygian Screwte
flesh crawler|Flesh Crawler
flies|Mouches
flight kilisa|Flight Kilisa
flippa|Flippa
floating column|Colonne flottante
flockleader geerin|Chef de troupeau Geerin
floki|Floki
floopa|Floopa
floria|Floria
florin|Florin
flosi dalksson|Flosi Dalksson
flower|Fleur
flower girl|Fleuriste
flowering bush|Buisson fleuri
fly trap|Piège à mouches
flying book|Livre volant
flying papers|Papiers volants
flying squirrel|Écureuil volant
flynn|Flynn
forebearer fides|Ancêtre Fides
forebearer honos|Ancêtre Honos
forebearer janus|Ancêtre Janus
forebearer vulcan|Forebearer Vulcan
foreman|Foreman
forester|Forester
forgotten soul|Forgotten Soul
former vampyre|Ancien vampire
fornek quo maten|Fornek quo Maten
fortress guard|Garde de la forteresse
fortunato|Fortunato
fossegrimen|Fossegrimen
fossil collector|Collectionneur de fossiles
fox|Renard
fox trap|Piège à renard
fragment of seren|Fragment de Seren
francis|Francis
francois|François
frank|Frank
frankie|Frankie
franklin caranos|Franklin Caranos
freaky forester|Forestier bizarre
freald|Freald
fred the farmer|Fred le fermier
freidir|Freidir
freja|Freja
fremennik warband archer|Archer de la bande de guerre Fremennik
fremennik warband berserker|Berserker de la bande de guerre Fremennik
fremennik warband seer|Voyant de la bande de guerre Fremennik
fremennik warrior|Guerrier fremennik
frenita|Frenita
frenzied ice troll female|Troll des glaces frénétique femelle
frenzied ice troll grunt|Troll des glaces frénétique grognon
frenzied ice troll male|Troll des glaces frénétique mâle
frenzied ice troll runt|Troll des glaces frénétique chétif
freygerd|Freygerd
fridgeir|Fridgeir
fridleif shieldson|Fridleif Shieldson
friendly bees|Abeilles amicales
friendly ent|Ent amical
friendly forester|Forestier amical
frigatebird|Frigatebird
frightened fox|Renard effrayé
frincos|Frincos
fritz the glassblower|Fritz le souffleur de verre
frizzy skernip|Frizzy Skernip
frog|Grenouille
frog prince|Prince grenouille
frog princess|Princesse grenouille
frogeel|Frogeel
froono|Froono
frost crab|Crabe des glaces
frost dragon|Dragon des glaces
frost nagua|Nagua des glaces
frosty snakeling|Serpent des glaces
frosty spider|Araignée des glaces
frozen orb|Orbe gelé
frozen weapons|Armes gelées
fruit bat|Chauve-souris frugivore
fry|Fry
fuggy|Fuggy
fullangr|Fullangr
fumus|Fumus
funbo|Funbo
fur merchant|Marchand de fourrures
fur trader|Marchand de fourrures
furia tullus|Furia Tullus
furnace grate|Grille de fourneau
fycie|Fycie
fyiona fray|Fyiona Fray
g.l.o. caranock|G.L.O. Caranock
gabba, apprentice coral farmer|Gabba, apprenti cultivateur de corail
gabooty|Gabooty
gabriela|Gabriela
gadderanks|Gadderanks
gadrin|Gadrin
gaius|Gaius
galahad|Galahad
galana|Galana
galathil|Galathil
galina|Galina
gallow|Gallow
galna|Galna
galvek|Galvek
gamer|Gamer
gamfred|Gamfred
gang boss|Chef de gang
gangster|Gangster
garai|Garai
garbek quo maten|Garbek quo Maten
garden supplier|Fournisseur de jardinage
gardener|Jardinier
gardener ghost|Jardinier fantôme
gardener gunnhild|Jardinier Gunnhild
gardener jay jr.|Jardinier Jay Jr.
gargh|Gargh
gargoyle|Gargouille
garkor|Garkor
garl|Garl
garth|Garth
garv|Garv
gary|Gary
gate of war|Porte de la guerre
gatekeeper|Gardien
gauss|Gauss
gecko|Gecko
gee|Gee
gelatinnoth mother|Gelatinnoth Mother
gelin|Gelin
gelmir|Gelmir
gem|Gem
gem merchant|Marchand de gemmes
gem trader|Négociant en gemmes
gemstone crab|Crabe gemme
gene|Gène
general babacus|Général Babacus
general bentnoze|Général Bentnoze
general danknuck|Général Danknuck
general graardor|Général Graardor
general hining|Général Hining
general khazard|Général Khazard
general kilian|Général Kilian
general salara|Général Salara
general vir|Général Vir
general wartface|Général Wartface
generic diplomat|Diplomate générique
generous treater|Généreux traiteur
genie|Génie
george laxmeister|George Laxmeister
georgy|Georgy
gerald|Gerald
gerardus|Gerardus
gerrant|Gerrant
gertrude|Gertrude
gertrude's cat|Le chat de Gertrude
gethin|Gethin
ghaslor the elder|Ghaslor l'Ancien
ghast|Ghast
ghommal|Ghommal
ghost|Fantôme
ghost banker|Banquier fantôme
ghost captain|Capitaine fantôme
ghost cat|Chat fantôme
ghost disciple|Disciple fantôme
ghost farmer|Fermier fantôme
ghost guard|Garde fantôme
ghost innkeeper|Aubergiste fantôme
ghost sailor|Marin fantôme
ghost shopkeeper|Commerçant fantôme
ghost villager|Villageois fantôme
ghostly figure|Silhouette fantomatique
ghostly thrall|Esclave fantomatique
ghoul|Goule
ghoul champion|Champion goule
gianne jnr.|Gianne jnr.
giant|Géant
giant ant|Fourmi géante
giant bat|Chauve-souris géante
giant champion|Champion géant
giant clam|Palourde géante
giant crypt rat|Rat géant des cryptes
giant crypt spider|Araignée géante des cryptes
giant frog|Grenouille géante
giant goblin|Gobelin géant
giant lobster|Homard géant
giant mole|Taupe géante
giant mosquito|Moustique géant
giant rat|Rat géant
giant roc|Roc géant
giant rock crab|Crabe géant des rochers
giant rockslug|Escargot géant
giant scarab|Scarabée géant
giant sea snake|Serpent de mer géant
giant skeleton|Squelette géant
giant snail|Escargot géant
giant spider|Araignée géante
giant squirrel|Écureuil géant
giant toad|Crapaud géant
giant wasp|Guêpe géante
gielinor guide|Guide de Gielinor
gilbert|Gilbert
giles|Giles
gileth|Gileth
gillie groats|Gillie Groats
giral bat|Chauve-souris Giral
gita prymes|Gita Prymes
glacies|Glacies
gladiator|Gladiateur
glanton|Glanton
glenda|Glenda
glod|Glod
glorfindel|Glorfindel
gloria|Gloria
gloria kebbit-monkfish|Gloria Kebbit-Monkfish
glough|Glough
glouphrie the untrusted|Glouphrie l'Indigne
glowing crystal|Cristal lumineux
gnocci the cook|Gnocci le cuisinier
gnome|Gnome
gnome archer|Gnome archer
gnome ball referee|Arbitre gnome
gnome baller|Joueur gnome
gnome banker|Banquier gnome
gnome child|Enfant gnome
gnome coach|Entraîneur gnome
gnome driver|Chauffeur gnome
gnome emissary|Émissaire gnome
gnome guard|Garde gnome
gnome inspector|Inspecteur gnome
gnome mage|Mage gnome
gnome shop keeper|Commerçant gnome
gnome soldier|Soldat gnome
gnome trainer|Entraîneur gnome
gnome traveller|Voyageur gnome Levele 1
gnome troop|Troupe gnome
gnome waiter|Serveur gnome
gnome winger|Ailier gnome
gnome woman|Femme gnome
gnormadium avlafrim|Gnormadium Avlafrim
gnosi|Gnosi
goat|Chèvre
goat poo|Crottes de chèvre
goblin|Gobelin
goblin champion|Champion gobelin
goblin cook|Cuisinier gobelin
goblin fish|Poisson gobelin
goblin guard|Garde gobelin
goblin lieutenant|Lieutenant gobelin
goblin priest|Prêtre gobelin
goblin raider|Pillard gobelin
goblin recruiter|Recruteur gobelin
goblin scribe|Scribe gobelin
godric|Godric
gold ore|Minerai d'or
golden sheep|Mouton doré
golden warbler|Fauvette dorée
golem|Golem
golem guard|Golem garde
golova|Golova
golrie|Golrie
goopy snake|Serpent gluant
goose|Oie
gorad|Gorad
gorak|Gorak
gordon|Gordon
goreu|Goreu
gorhak quo narga|Gorhak quo Narga
gorilla|Gorille
gossip|Gossip
gourmet|Gourmet
gourmet impling|Gourmet impling
gpdt employee|Employé GPDT
grace|Grace
gracefish shoal|Gracefish Shoal
grail maiden|Grail Maiden
grand exchange clerk|Grand Exchange Clerk
grandpa jack|Grandpa Jack
grave|Grave
grave digger|Grave digger
grave scorpion|Grave scorpion
graveyard guardian|Gardien du cimetière
gravingas|Gravingas
greasycheeks|Greasycheeks
great olm|Grand Olm
great white shark|Grand requin blanc
greater abyssal demon|Grand démon abyssal
greater demon|Démon supérieur
greater ghostly thrall|Esclave fantomatique supérieur
greater nechryael|Grand Nechryael
greater skeletal thrall|Esclave squelettique supérieur
greater skeleton hellhound|Grand squelette chien de l'enfer
greater zombified thrall|Esclave zombifié supérieur
greatscott85|GreatScott85
green dragon|Dragon vert
green fireflies|Lucioles vertes
green gemstone director|Directeur des pierres précieuses vertes
green gemstone secretary|Secrétaire des pierres précieuses vertes
green guard|Garde vert
green h'ween mask|Masque d'Halloween vert
green partyhat|Chapeau de fête vert
green sheep|Mouton vert
green skink|Scincide verte
greengrocer|Marchand de fruits et légumes
gregg|Gregg
gregory|Gregory
greldo|Greldo
grew|Grew
grey golem|Golem gris
griems|Griems
grigor rasputin|Grigor Raspoutine
grigore|Grigore
grimesquit|Grimesquit
grimgnash|Grimgnash
grimy lizard|Lézard crasseux
grinka krast|Grinka Krast
grip|Grip
grish|Grish
grizzly bear|Ours grizzly
grizzly bear cub|Ourson grizzly
grotesque guardians|Gardiens grotesques
group ironman tutor|Tuteur Ironman de groupe
group storage tutor|Tuteur Stockage de groupe
growler|Growler
growthling|Growthling
grub|Grub
grubfoot|Grubfoot
grubor|Grubor
gruff mcscruff|Gruff McScruff
grug|Grug
gruh|Gruh
grum|Grum
grundt|Grundt
grunsh|Grunsh
gruva patrull|Gruva Patrull
gryphon|Gryphon
guanic bat|Guanic bat
guard|Garde
guard bandit|Garde bandit
guard captain|Capitaine des gardes
guard dog|Chien de garde
guard recruiter|Recruteur des gardes
guard vemmeldo|Garde Vemmeldo
guardian|Gardien
guardian drake|Gardien Drake
guardian mummy|Gardien momie
guardian of armadyl|Gardien d'Armadyl
guardian thrall|Esclave gardien
guidor|Guidor
guild hunter aco|Chasseur de guilde Aco
guild hunter cervus|Chasseur de guilde Cervus
guild hunter fox|Chasseur de guilde Fox
guild hunter kiko|Chasseur de guilde Kiko
guild hunter ornus|Chasseur de guilde Ornus
guild hunter teco|Chasseur de guilde Teco
guild hunter wolf|Chasseur de guilde Wolf
guild scribe verity|Scribe de guilde Verity
guildmaster|Maître de guilde
guildmaster apatura|Maître de guilde Apatura
guildmaster jane|Maître de guilde Jane
guildmaster lars|Maître de guilde Lars
guilin|Guilin
guinevere|Guinevere
gujuo|Gujuo
gull|Gull
gulldamar|Gulldamar
gulluck|Gulluck
gundai|Gundai
gundik|Gundik
gunnar holdstrom|Gunnar Holdstrom
gunnjorn|Gunnjorn
gunslik|Gunslik
gunthor the brave|Gunthor le courageux
guppa|Guppa
gurl|Gurl
gurtob|Gurtob
gus|Gus
guss mistletoad|Guss Mistletoad
guthan the infested|Guthan l'Infesté
gwallter|Gwallter
gwerin hapus|Gwerin Hapus
gwindor|Gwindor
gwyl|Gwyl
gwyn|Gwyn
gwyna|Gwyna
gyr falcon|Gyr Falcon
h.a.m. archer|Archer H.A.M.
h.a.m. deacon|Diacre H.A.M.
h.a.m. guard|Garde H.A.M.
h.a.m. mage|Mage H.A.M.
h.a.m. member|Membre H.A.M.
habibah|Habibah
hadley|Hadley
haemas lamescus|Haemas Lamescus
haera|Haera
hafuba|Hafuba
hagus|Hagus
hairdresser|Coiffeur
hajedy|Hajedy
haldor quo keran|Haldor quo Keran
half full wine jug|Cruche de vin à moitié pleine
half-soulless|Demi-sans-âme
half-zombie|Demi-zombie
halla|Halla
hallak|Hallak
hallifred|Hallifred
ham member|Membre HAM
hamab|Hamab
hamal the chieftain|Hamal le chef de clan
hambling|Hambling
hameln the jester|Hameln le bouffon
hamid|Hamid
haming|Haming
hammerhead shark|Requin-marteau
hammerspike stoutbeard|Hammerspike Stoutbeard
hanchen the hound|Hanchen le Chien
hangman game|Jeu du pendu
hank|Hank
hannibal|Hannibal
hans|Hans
hari|Hari
haris|Haris
harminia|Harminia
harold|Harold
harold evans|Harold Evans
harpert|Harpert
harpie bug swarm|Essaim de harpies
harpy eagle|Aigle harpie
harrallak menarous|Harrallak Menarous
harry|Harry
harvester|Moissonneuse
haskell|Haskell
hassan|Hassan
hatius cosaintus|Hatius Cosaintus
hatna|Hatna
hats & scarves|Chapeaux et écharpes
haze|Haze
hazeel|Hazeel
hazeel cultist|Cultiste Hazeel
hazelmere|Hazelmere
hazelmere's hat|Chapeau de Hazelmere
head|Tête
head butler|Majordome en chef
head chef|Chef cuisinier
head guard|Chef des gardes
head menaphite guard|Chef des gardes ménaphites
head mourner|Chef des pleureurs
head servant|Serviteur en chef
head thief|Chef voleur
headless beast|Bête sans tête
healing totem|Totem de guérison
healthorg and tortoise|Healthorg et tortue
heckel funch|Heckel Funch
hegio, teoki of ranul|Hegio, Teoki de Ranul
hegir|Hegir
helemos|Helemos
helena|Helena
helga|Helga
hell-rat|Rat de l'enfer
hell-rat behemoth|Rat de l'enfer Behemoth
hellcat|Chat de l'enfer
hellhound|Chien de l'enfer
hellpuppy|Chiot de l'enfer
helpful spirit|Esprit serviable
helvia|Helvia
henderson|Henderson
hendor|Hendor
hengel|Hengel
hengrad|Hengrad
henja|Henja
henryeta carnillean|Henryeta Carnillean
herbi|Herbi
herbiboar|Herbiboar
herman caranos|Herman Caranos
hermit|Hermite
hermit crab|Crabes ermites
hero|Héros
heron|Héron
herquin|Herquin
hervi|Hervi
heskel|Heskel
hespori|Hespori
het|Het
het's seal|Sceau de Het
hetty|Hetty
hewey|Hewey
hickton|Hickton
hieve|Hieve
high priest|Grand prêtre
high priest bighead|Grand prêtre Bighead
high priest of scabaras|Grand prêtre de Scabaras
high priestess zul-harcinqa|Grande prêtresse Zul-Harcinqa
highlord katlo|Grand seigneur Katlo
highwayman|Bandit de grand chemin
hild|Hild
hill giant|Géant des collines
hirko|Hirko
historian aldo|Historien Aldo
historian duffy|Historien Duffy
historian minas|Historien Minas
hiylik myna|Hiylik Myna
hobbes|Hobbes
hobgoblin|Hobgoblin
hobgoblin champion|Champion hobgoblin
hobgoblin guard|Garde hobgoblin
hofuthand|Hofuthand
hogst|Hogst
holgart|Holgart
holly|Holly
holoy|Holoy
holthion|Holthion
homunculus|Homunculus
honest jimmy|Honest Jimmy
honour guard|Garde d'honneur
hooded figure|Personnage encapuchonné
hooded stranger|Étranger encapuchonné
hooknosed jack|Jack au nez crochu
hoop snake|Serpent cerceau
hopeless creature|Créature désespérée
hopleez|Hopleez
hops|Hops
horace|Horace
horacio|Horacio
hordal|Hordal
horned graahk|Graahk à cornes
horphis|Horphis
horvik|Horvik
hosa|Hosa
house|Maison
hrh hrafn|HRH Hrafn
hring hring|Hring Hring
huberte|Huberte
hudo|Hudo
hudon|Hudon
huge spider|Araignée géante
hugh|Hugh
hugor|Hugor
huito|Huito
humphrey dumphrey|Humphrey Dumphrey
humroc|Humroc
hunding|Hunding
hunter guild member|Membre de la guilde des chasseurs
hunting expert|Expert en chasse
huntmaster gilman|Maître chasseur Gilman
hura|Hura
husk|Husk
hutza|Hutza
hydra|Hydra
hygd|Hygd
ian|Ian
iban|Iban
ice block|Bloc de glace
ice demon|Démon des glaces
ice elemental|Élémentaire de glace
ice giant|Géant de glace
ice queen|Reine des glaces
ice spider|Araignée de glace
ice totem|Totem de glace
ice troll|Troll des glaces
ice troll female|Troll de glace femelle
ice troll grunt|Troll de glace grognon
ice troll king|Roi des trolls des glaces
ice troll male|Troll de glace mâle
ice troll runt|Troll des glaces nain
ice warrior|Guerrier des glaces
ice wolf|Loup des glaces
iceberg|Iceberg
icefiend|Démon des glaces
icelord|Seigneur des glaces
ichta|Ichta
icicle|Glaçon
icicles|Glaçons
icthlarin|Icthlarin
ictus|Ictus
ide|Ide
idria|Idria
idril|Idril
idris|Idris
ifaba|Ifaba
iffie|Iffie
ignatius vulcan|Ignatius Vulcan
ignisia|Ignisia
iguana|Iguana
ikkle hydra|Ikkle hydra
ikniu|Ikniu
ileana|Ileana
ilfeen|Ilfeen
ima|Ima
imerominia|Imerominia
imia|Imia
imiago|Imiago
imin|Imin
iminye|Iminye
immenizz|Immenizz
imp|Imp
imp champion|Imp Champion
imp defender|Imp defender
imre|Imre
indis|Indis
infernal mage|Infernal Mage
infernal pyrelord|Infernal pyrelord
information clerk|Information clerk
inga|Inga
ingrid|Ingrid
ingrid hradson|Ingrid Hradson
ingwe|Ingwe
ingwion|Ingwion
injured tortugan|Injured Tortugan
inn keeper|Aubergiste
innocent-looking key|Clé à l'apparence innocente
insatiable bloodveld|Bloodveld insatiable
insatiable mutated bloodveld|Bloodveld mutant insatiable
intruder|Intrus
invrigar the necromancer|Invrigar le nécromancien
iona|Iona
iorwerth archer|Archer d'Iorwerth
iorwerth warrior|Guerrier d'Iorwerth
irena|Irena
irene|Irene
irina|Irina
irksol|Irksol
iron bill|Iron Bill
iron dragon|Dragon de fer
iron ore|Minerai de fer
ironman tutor|Tuteur Ironman
irvig senay|Irvig Senay
irwin feaselbaum|Irwin Feaselbaum
isadora|Isadora
ish the navigator|Ish le Navigateur
ishmael|Ishmael
islwyn|Islwyn
istoria|Istoria
ithoi the navigator|Ithoi le Navigateur
ivan|Ivan
ivan strom|Ivan Strom
ivy|Ivy
ivy sophista|Ivy Sophista
iwan|Iwan
iwazaru|Iwazaru
izel|Izel
jabari|Jabari
jack|Jack
jack frost|Jack Frost
jack lantern mask|Masque de Jack-o'-lanterne
jack sails|Jack Sails
jack seagull|Jack Seagull
jackal|Jackal
jacky jester|Jacky Jester
jacobm7|JacobM7
jade|Jade
jadid|Jadid
jagbakoba|Jagbakoba
jaguar|Jaguar
jaguar cub|Bébé jaguar
jaguar egg|Œuf de jaguar
jaguar spirit|Esprit jaguar
jaguar warrior|Guerrier jaguar
jail guard|Gardien de prison
jailer|Bourreau
jake|Jake
jal-ak|Jal-Ak
jal-akrek-ket|Jal-AkRek-Ket
jal-akrek-mej|Jal-AkRek-Mej
jal-akrek-xil|Jal-AkRek-Xil
jal-imkot|Jal-ImKot
jal-mejjak|Jal-MejJak
jal-mejrah|Jal-MejRah
jal-nib|Jal-Nib
jal-nib-rek|Jal-nib-rek
jal-xil|Jal-Xil
jal-zek|Jal-Zek
jaltok-jad|JalTok-Jad
james|James
jamila|Jamila
jane|Jane
jaraah|Jaraah
jardric|Jardric
jari|Jari
jarr|Jarr
jarvald|Jarvald
jasper|Jasper
jatix|Jatix
jatziri, teoki of ralos|Jatziri, Teoki de Ralos
javelin colossus|Javelin Colossus
jayene kliyn|Jayene Kliyn
jeb|Jeb
jeed|Jeed
jeff|Jeff
jelly|Jelly
jennella|Jennella
jennifer|Jennifer
jenny blade|Jenny Blade
jerboa|Jerboa
jeremy clerksin|Jeremy Clerksin
jerico|Jerico
jess|Jess
jessamine|Jessamine
jessie|Jessie
jethick|Jethick
jewelled crab|Jewelled Crab
jex|Jex
jhallan|Jhallan
jig cart|Chariot à gabarit
jill|Jill
jim|Jim
jiminua|Jiminua
jimmy|Jimmy
jimmy dazzler|Jimmy Dazzler
jimmy the chisel|Jimmy le Ciseau
jittery jim|Jim nerveux
jobless jim|Jim le chômeur
joe|Joe
jofridr mordstatter|Jofridr Mordstatter
jogre|Jogre
jogre champion|Champion Jogre
johanhus ulsbrecht|Johanhus Ulsbrecht
john|John
johnathon|Johnathon
joint-chief mouser to the shipyard office|Chef adjoint Mouser au bureau du chantier naval
jokul|Jokul
jolly jim|Jolly Jim
jon|Jon
jonathan|Jonathan
jonny the beard|Jonny la Barbe
jorra|Jorra
jorral|Jorral
jorzik|Jorzik
joseph|Joseph
joshua|Joshua
jossik|Jossik
joyfuljudy02|JoyfulJudy02
juatil|Juatil
jubbly bird|Jubbly bird
jubster|Jubster
judge of yama|Juge de Yama
jug|Jug
jukat|Jukat
julia|Julia
julie|Julie
juliet|Juliet
jumaane|Jumaane
jumbo jim|Jumbo Jim
juna|Juna
jungle demon|Démon de la jungle
jungle eagle|Aigle de la jungle
jungle forester|Forestier de la jungle
jungle horror|Horreur de la jungle
jungle spider|Araignée de la jungle
jungle wolf|Loup de la jungle
junior jim|Junior Jim
junior navigator|Junior Navigator
jury|Jury
justiciar zachariah|Justiciar Zachariah
justin servil|Justin Servil
justine|Justine
juvenile custodian stalker|Juvenile custodian stalker
jyn|Jyn
k'klik|K'klik
k'ril tsutsaroth|K'ril Tsutsaroth
kaal-ket-jor|Kaal-Ket-Jor
kaal-mej-san|Kaal-Mej-San
kaal-xil-dar|Kaal-Xil-Dar
kael forshaw|Kael Forshaw
kaht b'alam|Kaht B'alam
kai|Kai
kaleb paramaya|Kaleb Paramaya
kali|Kali
kalko|Kalko
kalphite guardian|Gardien kalphite
kalphite larva|Larve kalphite
kalphite princess|Princesse kalphite
kalphite queen|Reine kalphite
kalphite soldier|Soldat kalphite
kalphite worker|Ouvrier kalphite
kalrag|Kalrag
kalron|Kalron
kamen|Kamen
kamfreena|Kamfreena
kamil|Kamil
kanel|Kanel
kangai mau|Kangai Mau
kaqemeex|Kaqemeex
karaday|Karaday
karam|Karam
karamel|Karamel
karamjan tiger shark|Requin tigre de Karamjan
karamthulhu|Karamthulhu
kardia|Kardia
karil the tainted|Karil le Corrompu
karim|Karim
karl|Karl
kasonde|Kasonde
kasonde the craven|Kasonde le Lâche
kaston|Kaston
kathy corkat|Kathy Corkat
katrine|Katrine
kauayotl|Kauayotl
kaylee|Kaylee
kazemde|Kazemde
kazgar|Kazgar
kebba|Kebba
kebbit|Kebbit
keef|Keef
keepa kettilon|Keepa Kettilon
keith|Keith
kelvin|Kelvin
kelyn|Kelyn
kendall|Kendall
kenelme|Kenelme
kennith|Kennith
kent|Kent
kephri|Kephri
kephri's phantom|Fantôme de Kephri
ket'sal k'uk|Ket'sal K'uk
ket-zek|Ket-Zek
ketla|Ketla
ketla the unworthy|Ketla l'Indigne
key master|Maître des clés
kgp agent|Agent KGP
kgp guard|Garde KGP
kharazi monodon|Kharazi monodon
kharid scorpion|Scorpion de Kharid
kharrim|Kharrim
khazard barman|Barman de Khazard
khazard commander|Commandant de Khazard
khazard guard|Garde de Khazard
khazard launderer|Blanchisseur de Khazard
khazard ogre|Ogre de Khazard
khazard scorpion|Scorpion de Khazard
khazard soldier|Soldat de Khazard
khazard trooper|Soldat de Khazard
khazard warlord|Seigneur de guerre de Khazard
khorvak, a dwarven engineer|Khorvak, ingénieur nain
kikazaru|Kikazaru
killer|Tueur
killerwatt|Killerwatt
kilron|Kilron
kimba|Kimba
kineer|Kineer
king|Roi
king arthur|Roi Arthur
king black dragon|Roi Black Dragon
king bolren|Roi Bolren
king bolrie|Roi Bolrie
king gjuki sorvott iv|Roi Gjuki Sorvott IV
king healthorg|Roi Healthorg
king kurask|Roi Kurask
king lathas|Roi Lathas
king narnode shareen|Roi Narnode Shareen
king rat|Roi Rat
king roald|Roi Roald
king sand crab|Roi Sand Crab
king scorpion|Roi Scorpion
king snagwort|Roi Snagwort
king thoros|Roi Thoros
king vargas|Roi Vargas
king's messenger|Messager du roi
kit breaker|Kit Breaker
kitten|Chaton
kiyahtla|Kiyahtla
kjedelig uppsen|Kjedelig Uppsen
kjut|Kjut
klank|Klank
klarense|Klarense
klaus|Klaus
klenter|Klenter
knight|Chevalier
knight of ardougne|Chevalier d'Ardougne
knight of saradomin|Chevalier de Saradomin
knight of the lion|Chevalier du Lion
knight of the owl|Chevalier du Hibou
knight of the unicorn|Chevalier de la Licorne
knight of the wolf|Chevalier du Loup
knight of varlamore|Chevalier de Varlamore
koanee|Koanee
kob|Kob
koftik|Koftik
kolodion|Kolodion
konar quo maten|Konar quo Maten
konoo|Konoo
korgan|Korgan
kormar quo maten|Kormar quo Maten
kortan|Kortan
koschei the deathless|Koschei l'immortel
kovac|Kovac
kragen|Kragen
kragin|Kragin
kraka|Kraka
kraken|Kraken
krato|Krato
kree'arra|Kree'arra
kroy|Kroy
kruk|Kruk
kryket bat|Chauve-souris Kryket
krystilia|Krystilia
ksenia|Ksenia
kualti|Kualti
kuradal|Kuradal
kurask|Kurask
kurt|Kurt
kylie minnow|Kylie Minnow
lacey|Lacey
lady carys hefin|Lady Carys Hefin
lady crombwick|Lady Crombwick
lady ffion meilyr|Lady Ffion Meilyr
lady keli|Lady Keli
lady nadezhda shadum|Lady Nadezhda Shadum
lady servil|Lady Servil
lady shauna piscarilius|Lady Shauna Piscarilius
lady table|Lady Table
lady tangwen trahaearn|Lady Tangwen Trahaearn
lady vulcana lovakengj|Lady Vulcana Lovakengj
lahsram|Lahsram
laidee gnonock|Laidee Gnonock
lalli|Lalli
lamb|Lamb
lammy langle|Lammy Langle
lan the butcher|Lan le boucher
lanthus|Lanthus
lanzig|Lanzig
large chicken|Grand poulet
large egg|Grand œuf
large mosquito|Grand moustique
large reef shark|Grand requin de récif
large tendril|Grande vrille
large zombie monkey|Grand singe zombie
larran|Larran
larrissa|Larrissa
larry|Larry
larry leprechaun|Larry Leprechaun
larxus|Larxus
lasenna rasputin|Lasenna Rasputin
lassin|Lassin
latlink fastbell|Latlink Fastbell
launa|Launa
lauretta|Lauretta
lava beast|Bête de lave
lava dragon|Dragon de lave
lava strykewyrm|Lava Strykewyrm
lavinia|Lavinia
layleen|Layleen
lazim|Lazim
lazy cat|Chat paresseux
lazylaura94|LazyLaura94
le-sabrè|Le-sabrè
lead navigator|Navigateur en chef
lead ore|Minerai de plomb
league navigator|Navigateur de ligue
league tutor|Tuteur de ligue
leagues assistant|Assistant de ligue
leagues tutor|Tuteur des ligues
leatherworker|Maroquinier
lector gura|Lector Gura
leech|Sangsue
leech display|Affichage des sangsues
leela|Leela
leenz|Leenz
leff|Leff
legends' guard|Garde des légendes
leke quo keran|Leke quo Keran
lelia|Lelia
lennissa|Lennissa
lenny|Lenny
lensa|Lensa
lenwe|Lenwe
lenyig karna|Lenyig Karna
leo|Leo
leon|Leon
leon d'cour|Leon d'Cour
lesser demon|Démon mineur
lesser demon champion|Champion démon mineur
lesser fanatic|Fanatique mineur
lesser ghostly thrall|Esclave fantomatique mineur
lesser skeletal thrall|Esclave squelettique mineur
lesser zombified thrall|Esclave zombifié mineur
lev|Lev
li'l lamb|Petit agneau
liam|Liam
librarian|Bibliothécaire
lidio|Lidio
lieutenant|Lieutenant
lieutenant schepbur|Lieutenant Schepbur
lieve mccracken|Lieve McCracken
light creature|Créature de lumière
light leech|Sangsue de lumière
lightning cloud|Nuage de foudre
lil' creator|Petit créateur
lil' zik|Petit zik
lil'viathan|Lil'viathan
lilifang|Lilifang
liliwen|Liliwen
liliya|Liliya
lillia|Lillia
lilly|Lilly
lindir|Lindir
ling|Ling
lisa|Lisa
lisse isaakson|Lisse Isaakson
litara|Litara
lithil|Lithil
litlihui, teoki of ralos|Litlihui, Teoki de Ralos
little mo|Little Mo
little monster|Petit monstre
little nightmare|Petit cauchemar
livius|Livius
lizard|Lézard
lizard display|Exposition de lézards
lizard man|Homme lézard
lizardman|Homme-lézard
lizardman brute|Brute homme-lézard
lizardman shaman|Chaman homme-lézard
lleidr golau|Lleidr Golau
lliann|Lliann
llio|Llio
loading crane|Grue de chargement
loar shade|Ombre de Loar
lobstrosity|Lobstrosity
local gnome|Gnome local
locke mcscruff|Locke McScruff
locked|Verrouillé
locust|Locuste
locust rider|Cavalier locuste
lofu|Lofu
logava|Logava
logios|Logios
logosia|Logosia
loinur|Loinur
lokar searunner|Lokar Searunner
loki|Loki
lokraa quo sihar|Lokraa quo Sihar
lola|Lola
lollk|Lollk
long-tailed wyvern|Wyvern à longue queue
longbow ben|Longbow Ben
longhall bouncer|Longhall Bouncer
longramble|Longramble
look-out|Look-out
looming shadow|Ombre menaçante
lord alexei jovkai|Seigneur Alexei Jovkai
lord baxtorian cadarn|Seigneur Baxtorian Cadarn
lord crombwick|Seigneur Crombwick
lord daquarius|Seigneur Daquarius
lord iestin iorwerth|Seigneur Iestin Iorwerth
lord ieuan amlodd|Seigneur Ieuan Amlodd
lord iorwerth|Seigneur Iorwerth
lord kandur hosidius|Seigneur Kandur Hosidius
lord marshal brogan|Seigneur Marshal Brogan
lord mischa myrmel|Seigneur Mischa Myrmel
lord piquan crwys|Seigneur Piquan Crwys
lord rologarth|Seigneur Rologarth
lord shiro shayzien|Seigneur Shiro Shayzien
lord trobin arceuus|Seigneur Trobin Arceuus
lorelai|Lorelai
lornor quo narga|Lornor quo Narga
lorraine|Lorraine
lost barbarian|Barbare perdu
lost camphor crate|Caisse de camphre perdue
lost casket|Cercueil perdu
lost ironwood crate|Caisse en bois de fer perdue
lost mahogany crate|Caisse en acajou perdue
lost oak crate|Caisse en chêne perdue
lost soul|Âme perdue
lost teak crate|Caisse en teck perdue
lost wooden crate|Caisse en bois perdue
louie legs|Louie Legs
louisa|Louisa
lovada|Lovada
lovakengj engineer|Ingénieur Lovakengj
love|Love
love cats|Love Cats
lowe|Lowe
lowerniel drakan|Lowerniel Drakan
lubufu|Lubufu
lucas|Lucas
lucia|Lucia
lucien|Lucien
lucius|Lucius
lucky impling|Lucky impling
lucrezia|Lucrezia
lucy|Lucy
luke|Luke
lumberjack leif|Lumberjack Leif
lumbridge guide|Lumbridge Guide
lumdo|Lumdo
lumiere|Lumiere
luminata|Luminata
lumo|Lumo
luna|Luna
lunami|Lunami
lundail|Lundail
lunderwin|Lunderwin
lurgon|Lurgon
luscion|Luscion
luthas|Luthas
lutwidge|Lutwidge
lux grub|Lux grub
lynx|Lynx
lynx tamer|Lynx Tamer
lyra|Lyra
mac|Mac
macaroni penguin|Macaroni Penguin
macaw|Macaw
mad melvin96|Mad melvin96
mad skavid|Mad skavid
madam sikaro|Madam Sikaro
madame caldarium|Madame Caldarium
madison|Madison
maedhros|Maedhros
maeglin|Maeglin
mag|Mag
mage|Mage
mage of zamorak|Mage of Zamorak
magic axe|Hache magique
magic combat tutor|Tuteur de combat magique
magic instructor|Instructeur de magie
magic mark|Marque magique
magma strykewyrm|Magma strykewyrm
magnus gram|Magnus Gram
magpie impling|Magpie impling
mahtan|Mahtan
maid|Servante
mairin|Mairin
maisa|Maisa
major attack|Attaque majeure
major collect|Collecte majeure
major defend|Défense majeure
major heal|Soin majeur
makeover mage|Mage transformateur
mako|Mako
malak|Malak
malcolm|Malcolm
male amur leopard|Léopard d'Amour mâle
male lion|Lion mâle
male slave|Esclave mâle
male snow leopard|Léopard des neiges mâle
male tiger|Tigre mâle
malevolent mage|Mage malveillant
malignius mortifer|Malignius Mortifer
mallak quo keran|Mallak quo Keran
mama|Mama
mamma bufetta|Mamma Bufetta
mammoth|Mammouth
man|Homme
manauia|Manauia
mandrith|Mandrith
mandy|Mandy
maniacal monkey|Singe maniaque
maniacal monkey archer|Singe archer maniaque
manni the reveller|Manni le fêtard
manta ray|Raie manta
manticore|Manticore
marble gargoyle|Gargouille en marbre
marcellus|Marcellus
marcus|Marcus
marfet|Marfet
maria gadderanks|Maria Gadderanks
maria gunnars|Maria Gunnars
mariah|Mariah
marika|Marika
marina kebbit-monkfish|Marina Kebbit-Monkfish
marionette set|Ensemble de marionnettes
marisi|Marisi
marissa|Marissa
marius|Marius
marius giste|Marius Giste
mark|Mark
market guard|Garde du marché
market seller|Vendeur du marché
markog|Markog
marla|Marla
marley|Marley
marlo|Marlo
marm|Marm
marmor quo narga|Marmor quo Narga
marsha|Marsha
marten|Marten
martha rehnison|Martha Rehnison
martin holt|Martin Holt
martin the master gardener|Martin le maître jardinier
martin thwait|Martin Thwait
martina scorsby|Martina Scorsby
marv|Marv
marwolaeth dawnsio|Marwolaeth Dawnsio
mary|Mary
masked figure|Personnage masqué
master chef|Maître cuisinier
master crafter|Maître artisan
master farmer|Maître fermier
master fisher|Maître pêcheur
master navigator|Maître navigateur
master smithing tutor|Maître forgeron
matilda|Matilda
matthew|Matthew
matthias|Matthias
mattimeo|Mattimeo
mature custodian stalker|Stalker gardien mature
mawnis burowgar|Mawnis Burowgar
mawrth|Mawrth
mayor hobb|Maire Hobb
maz|Maz
mazchna|Mazchna
maze guardian|Gardien du labyrinthe
mazion|Mazion
me|Moi
me?|Moi ?
meat tree|Arbre à viande
meaty aura logist|Aura charnue Logist
meddwl ymlaen llaw|Meddwl Ymlaen Llaw
medium barrier|Barrière moyenne
medium catalytic guardian|Gardien catalytique moyen
medium elemental guardian|Gardien élémentaire moyen
medium ninja monkey|Singe ninja moyen
meegle|Meegle
megan|Megan
mehhar|Mehhar
meiyerditch citizen|Citoyen de Meiyerditch
meiyerditch miner|Mineur de Meiyerditch Levele Chauve
mekritus a'hara|Mekritus A'hara
melana moonlander|Melana Moonlander
melee combat tutor|Tuteur de combat au corps à corps
meleti|Meleti
melina|Melina
melvin|Melvin
melzar the mad|Melzar le Fou
memory of seren|Mémoire de Seren
menaphite akh|Menaphite Akh
menaphite guard|Garde menaphite
menaphite leader|Chef menaphite
menaphite shadow|Ombre menaphite
menaphite thug|Voyou menaphite
mercenary|Mercenaire
mercenary axeman|Mercenaire hacheur
mercenary captain|Capitaine mercenaire
mercenary mage|Mercenaire mage
mercy|Miséricorde
meredith|Meredith
merlin|Merlin
mernia|Mernia
mernik|Mernik
merrymax2000|MerryMax2000
meskhenet|Meskhenet
messenger|Messager
metarialus|Metarialus
meteora|Meteora
metla|Metla
metzli, teokan of ranul|Metzli, Teokan de Ranul
meztlan|Meztlan
mi-gor|Mi-Gor
mia|Mia
miala|Miala
miazrqa|Miazrqa
mihail|Mihail
mike|Mike
mikey|Mikey
miles|Miles
milla|Milla
milli rehnison|Milli Rehnison
millie miller|Millie Miller
miltog|Miltog
mime|Mime
mimm|Mimm
mind golem|Golem mental
mine cart|Chariot de mine
mine cart driver|Conducteur de chariot de mine
mine supervisor|Superviseur de mine
miner|Mineur
miner magnus|Mineur Magnus
miniature chaotic clouds|Miniature nuages chaotiques
miniaturemarie|MiniatureMarie
minimus|Minimus Levele Régulier
mining instructor|Instructeur minier Levele 2020 Tutoriel
mining tutor|Tuteur minier
minotaur|Minotaure
miodvetnir|Miodvetnir
miriam|Miriam
miriel|Miriel
mirrorback araxyte|Araxyte miroir
mischievous ghost|Fantôme espiègle
misdrievus shadum|Misdrievus Shadum
mishkal'un dorn|Mishkal'un Dorn
miss cheevers|Mlle Cheevers
miss schism|Mlle Schism
mist|Brouillard
mistag|Mistag
mithrellas|Mithrellas
mithril dragon|Dragon mithril
mithril ore|Minerai de mithril
mittens|Mitaines
mizaru|Mizaru
mod freddie|Mod Freddie
moe|Moe
mofina|Mofina
moggy|Moggy
mogre|Mogre
mogre guard|Mogre Guard
mogrim|Mogrim
molanisk|Molanisk
moldof|Moldof
mole display|Mole display
molly|Molly
molossus|Molossus Levele Chou
monk|Moine
monk of entrana|Moine d'Entrana Levele 1
monk of zamorak|Moine de Zamorak
monkey|Singe
monkey archer|Singe archer
monkey child|Enfant singe
monkey display|Écran singe
monkey guard|Garde singe
monkey minder|Gardien de singe
monkey on cow|Singe sur vache
monkey on unicorn|Singe sur licorne
monkey zombie|Singe zombie
monolith|Monolithe
monstrous basilisk|Basilic monstrueux
moonlight antelope|Antilope au clair de lune
moonlight cockatrice|Cockatrice au clair de lune
moonlight moth|Papillon de nuit au clair de lune
mora|Mora
mord gunnars|Mord Gunnars
mordan nikazsi|Mordan Nikazsi
morgan|Morgan
morgan le faye|Morgane Le Faye
morgiana|Morgiana
mori|Mori
morris|Morris
mort nightshade|Mort Nightshade
mort'ton local|Habitant de Mort'ton
morten holdstrom|Morten Holdstrom
mortina daubenton|Mortina Daubenton
morvran|Morvran
mosol rei|Mosol Rei
mosquito swarm|Essaim de moustiques
moss giant|Géant de mousse
moss guardian|Gardien de mousse
moss lizard|Lézard de mousse
mosschin|Mosschin
most of a zombie|La plupart d'un zombie
mother|Mère
mother mallum|Mère Mallum
moths|Papillons de nuit
mountain dwarf|Nain des montagnes
mountain goat|Chèvre de montagne
mountain guide|Guide de montagne
mountain toucan|Toucan des montagnes
mountain troll|Troll des montagnes Level 69
mounted terrorbird gnome|Gnome chevauchant un oiseau de terreur Level 31
mounted terrorchick gnome|Gnome chevauchant un poussin de terreur
mourner|Mourner
mouse|Souris
movario|Movario
moxi|Moxi
mr face|M. Face
mr. mordaut|M. Mordaut
ms. hynn terprett|Mme Hynn Terprett
mubariz|Mubariz
mudskipper|Sauterelle
mugger|Agresseur
mummy|Momie
mummy ashes|Cendres de momie Levele 1
munty|Munty
muphin|Muphin Levele Mêlée
murcaily|Murcaily Levele Sans bâton
murfet|Murfet
murky matt|Murky Matt
murky pat|Murky Pat
murng bat|Murng bat
murphy|Murphy
muruwoi|Muruwoi
museum guard|Gardien du musée Levele Zone de nettoyage du musée
mushroom|Champignon
mutated bloodveld|Bloodveld mutant
mutated terrorbird|Oiseau de terreur mutant
mutated tortoise|Tortue mutante
muttadile|Muttadile
my arm|Mon bras
myndill|Myndill
myre blamish snail|Escargot de Myre Blamish
mysterious adventurer|Aventurier mystérieux
mysterious bandit|Bandit mystérieux
mysterious figure|Personnage mystérieux
mysterious glow|Mysterious glow
mysterious old man|Vieil homme mystérieux
mysterious stranger|Étranger mystérieux
mysterious voice|Mysterious Voice
mysterious watcher|Mysterious Watcher
mystery figure|Mystery figure
mystery fruit|Fruit mystérieux
naghead|Naghead
nahta|Nahta
naiatli|Naiatli
nail beast|Bête à clous
nakasa jovkai|Nakasa Jovkai
nardah banker|Banquier de Nardah
nardok|Nardok
narf|Narf
narwhal|Narval
nasty nick|Nasty Nick
natalidae shadum|Natalidae Shadum
nathifa|Nathifa
natural historian|Historien naturel
nature impling|Nature impling
nazastarool|Nazastarool
nechryael|Nechryael
nechryarch|Nechryarch
necromancer|Nécromancien
necrovarus|Necrovarus
necto|Necto
ned|Ned
neferti the camel|Neferti le Chameau
neil|Neil
neite|Neite
nellas|Nellas
nelta of ralos|Nelta de Ralos
nelta of ranul|Nelta de Ranul
nemishka|Nemishka
nenetl, teoki of ranul|Nenetl, Teoki de Ranul
nerdanel|Nerdanel
nesty|Nesty
netmaster kellan|Netmaster Kellan
nevet|Nevet après la rencontre
new recruit tony|Nouvelle recrue Tony
newtroost|Newtroost
nex|Nex
nexling|Nexling
nezikchened|Nezikchened
nezketi|Nezketi
nia|Nia
nicholas|Nicholas
nick|Nick
nickel ore|Minerai de nickel
nickolaus|Nickolaus
nicoleta|Nicoleta
nid|Nid
nieve|Nieve
nigel|Nigel
night beast|Bête nocturne
nikita|Nikita
nikkie|Nikkie
nikolai|Nikolai
niles|Niles
niloof|Niloof
nimloth|Nimloth
nimrodel|Nimrodel
ninja impling|Ninja impling
nipper|Nipper
nirrie|Nirrie
nisha|Nisha
nkuku|Nkuku
no crewmember|Pas de membre d'équipage
noah|Noah
noctillion lugosi|Noctillion Lugosi
noella|Noella
nolar|Nolar
nomad|Nomad
noodle|Noodle
noon|Noon
nora t. hagg|Nora T. Hagg
noranna tytanin|Noranna Tytanin
norman|Norman
not bob|Not Bob
noterazzo|Noterazzo
nova|Nova
novice|Novice
nuclear smoke devil|Nuclear smoke devil
nulodion|Nulodion
numpty|Numpty
nung|Nung
nurmof|Nurmof
nurse boubou|Nurse Boubou
nurse emma gentsy|Nurse Emma Gentsy
nurse inn'juree|Nurse Inn'Juree
nurse sarah|Nurse Sarah
nurse wooned|Nurse Wooned
nylocas|Nylocas
nylocas athanatos|Nylocas Athanatos
nylocas hagios|Nylocas Hagios
nylocas ischyros|Nylocas Ischyros
nylocas matomenos|Nylocas Matomenos
nylocas prinkipas|Nylocas Prinkipas
nylocas queen|Nylocas Queen
nylocas toxobolos|Nylocas Toxobolos
nylocas vasilias|Nylocas Vasilias
oaknock the engineer|Oaknock l'ingénieur
oarswoman olga|Rameuse Olga
oath lord d'rows|Seigneur du serment D'rows
oathbreaker b'ats|Briseur de serment B'ats
oathbreaker e'piws|Briseur de serment E'piws
oathbreaker m'als|Briseur de serment M'als
obelisk|Obélisque
obli|Obli
obor|Obor
observatory assistant|Assistant d'observatoire
observatory professor|Professeur d'observatoire
ocean man|Homme de l'océan
ocelot|Ocelot
ocelot kitten|Chaton ocelot
ocga|Ocga
ochre blamish snail|Escargot ocre blamish
ocuil|Ocuil
odd figure|Personnage étrange
odd mushroom|Champignon étrange
odd old man|Vieil homme étrange
odd stone|Pierre étrange
oddskull|Oddskull
odmar|Odmar
odovacar|Odovacar
odysseus|Odysseus
og|Og
ogre|Ogre Levele GWD
ogre boat|Bateau ogre
ogre chieftain|Chef ogre
ogre guard|Garde ogre
ogre merchant|Marchand ogre
ogre monodon|Monodon ogre
ogre shaman|Chaman ogre
ogre trader|Marchand ogre
ogress shaman|Chamane ogresse
ogress warrior|Guerrière ogresse Levele 1
oipuis|Oipuis
okina|Okina
olaf|Olaf
olaf hradson|Olaf Hradson
olaf the bard|Olaf le barde Levele Normal
olbertus|Olbertus Levele Libéré
old crone|Vieille sorcière
old dwarf|Vieil nain
old grog|Vieux Grog
old man|Vieil homme
old man ral|Vieil homme Ral
old man yarlo|Vieil homme Yarlo Levele Cinématique
oldak|Oldak
oli|Oli
olivia|Olivia
ollie the camel|Ollie le chameau
olmlet|Olmlet
omart|Omart
one eyed rosalee|Rosalee à un œil
oneiromancer|Oneiromancer
oobapohk|Oobapohk
oomlie bird|Oiseau Oomlie
oozing barrier|Barrière suintante
operator|Opérateur Levele 1
oracle|Oracle
orange salamander|Salamandre orange
orb of darkness|Orbe des ténèbres Levele Akkha
orb of lightning|Orbe de foudre
orc|Orc
orca|Orca
ordan|Ordan
oriana|Oriana
ork|Ork
orlando smith|Orlando Smith
ornate undead combat dummy|Mannequin de combat mort-vivant décoré
oronwen|Oronwen
oropher|Oropher
orophin|Orophin
orrvor quo maten|Orrvor quo Maten
orsaga|Orsaga
orsaga's chinchompa|Chinchompa d'Orsaga
oryx|Oryx
oscar|Oscar
osian|Osian
osman|Osman
osmumten|Osmumten
ospak|Ospak
osprey|Osprey
osten|Osten
osvald|Osvald
oswald|Oswald
oswallt|Oswallt
othainian|Othainian
other half-zombie|Autre demi-zombie
otherworldly being|Être d'un autre monde
otto godblessed|Otto Godblessed
ouditor|Ouditor
ouhai|Ouhai
outlaw|Hors-la-loi Levele 1
overcharged barrier|Barrière surchargée
overcharged catalytic guardian|Gardien catalytique surchargé
overcharged elemental guardian|Gardien élémentaire surchargé
overgrown cat|Chat sauvage Levele 1
overseer khougo|Surveillant Khougo
owl|Hibou Levele 1
oxi|Oxi
oziach|Oziach
padulah|Padulah
pagida|Pagida
painted goblin|Gobelin peint
painted one|Peint
paladin|Paladin
palm of resourcefulness|Paume de l'ingéniosité Levele 0 %
palmer|Palmer
palum|Palum
pandur hosidius|Pandur Hosidius Levele Seigneur
panning guide|Guide de paillage
paola|Paola
parasite|Parasite
parleying preston|Preston le négociateur
parrot|Perroquet
parrots|Perroquets
parroty pete|Parroty Pete
party gnome|Gnome de fête
party pete|Party Pete
passionate supporter|Supporter passionné
patchy|Patchy
patrick|Patrick
patrolman|Patrouilleur
patrolwoman|Patrouilleuse
patty seer|Patty Seer
patzi|Patzi
pauline polaris|Pauline Polaris
pavo|Pavo
paws|Paws
pay-dirt|Pay-dirt
peaceful barbarian spirit|Esprit barbare pacifique
peasant|Paysan Levele Heureux
pebble|Pebble
pee hat|Pee Hat
peer|Peer
peer the seer|Peer le devin
peeve|Peeve
peksa|Peksa
pelican|Pélican
pellem|Pellem
penance fighter|Combattant pénitent
penance healer|Guérisseur pénitent
penance queen|Reine pénitente
penance ranger|Ranger pénitent
penance runner|Coureur pénitent
penda|Penda
penguin|Pingouin
penguin display|Pingouin d'exposition
pennant|Fanion
pentyn|Pentyn
penwie|Penwie
perdie|Perdie
perdu|Perdu
perfect gold ore|Minerai d'or parfait
perrdur|Perrdur
perry|Perry
persten the deceitful|Persten le Fourbe
pescaling pax|Pescaling Pax
pestilent bloat|Pestilent Bloat
pet chaos elemental|Animal de compagnie élémentaire du chaos
pet dagannoth prime|Animal de compagnie dagannoth prime
pet dagannoth rex|Animal de compagnie dagannoth rex
pet dagannoth supreme|Animal de compagnie dagannoth supreme
pet dark core|Animal de compagnie dark core
pet general graardor|Animal de compagnie général graardor
pet k'ril tsutsaroth|Animal de compagnie k'ril tsutsaroth
pet kraken|Animal de compagnie kraken
pet kree'arra|Animal de compagnie kree'arra
pet penance queen|Animal de compagnie penance queen
pet rock|Animal de compagnie rock
pet smoke devil|Animal de compagnie smoke devil
pet snakeling|Pet snakeling
pet zilyana|Pet zilyana
peter|Peter
petra fiyed|Petra Fiyed
petrified pete|Petrified Pete
petrus|Petrus
phabelle bile|Phabelle Bile
phantom|Phantom
phantom hand|Main fantôme
phantom muspah|Muspah fantôme
phantuwti fanstuwi farsight|Phantuwti Fanstuwi Farsight
pharaoh kemesis|Pharaon Kemesis
pheasant|Faisan
phials|Phials
phileas rimor|Phileas Rimor
philipe carnillean|Philipe Carnillean
phillipa|Phillipa
philop|Philop
phingspet|Phingspet
phluxia bat|Chauve-souris Phluxia
phoebe kay|Phoebe Kay
phoenix|Phénix
phosani's nightmare|Cauchemar de Phosani
phrin shade|Phrin Shade
picaria|Picaria
pierre|Pierre
pieve|Pieve
pig|Cochon
piglet|Cochonnet
pile of bones|Tas d'os
piles|Tas
pilg|Pilg
pilgrim|Pèlerin
piliar|Piliar
pillory guard|Garde du pilori
ping|Ping
pious pete|Pious Pete
pipistrelle draynar|Pipistrelle Draynar
pirate|Pirate
pirate captain|Capitaine pirate
pirate guard|Garde pirate
pirate jackie the fruit|Pirate Jackie le Fruit après le journal intime
pirate pete|Pirate Pete normal
pit scorpion|Scorpion des fosses
pizazz hat|Chapeau Pizazz
pkmaster0036|PKMaster0036
plague cow|Vache pestiférée
plague frog|Grenouille pestiférée
plough|Charrue
poacher|Braconnier
poison gas cloud|Nuage de gaz toxique
poison salesman|Vendeur de poison
poison scorpion|Scorpion venimeux
poison spider|Araignée venimeuse
polar eagle|Aigle polaire
polly|Polly
polmafi ferdygris|Polmafi Ferdygris
poltenip|Poltenip
pong|Pong
pontak|Pontak
ponts the bridgemaster|Ponts le maître des ponts
poor looking man|Homme pauvre
poor looking woman|Femme pauvre
porazdir|Porazdir
porcupine|Porc-épic
port master|Maître du port
port official|Fonctionnaire du port
port wizard paulie|Sorcier du port Paulie
port wizard perrie|Sorcier du port Perrie
port wizard peter|Sorcier du port Peter
port wizard petra|Sorcier du port Petra
port worker|Ouvrier portuaire
portal|Portail
portal of death|Portail de la mort
portobello|Portobello
possessed pickaxe|Pioche possédée
possessed priest|Prêtre possédé
postie pete|Postie Pete
pouncer|Pouncer
pox|Pox
prael bat|Prael bat
praistan ebola|Praistan Ebola
prayer tutor|Tuteur de prière
praying mantis|Mante religieuse Levele 1
preacher|Prédicateur
prescott|Prescott
preswylwyr dall|Preswylwyr Dall
prickly kebbit|Kebbit épineux
priest|Prêtre
priestess zul-gwenwynig|Prêtresse Zul-Gwenwynig
primio|Primio
primula|Primula
prince ali|Prince Ali
prince black dragon|Prince dragon noir
prince brand|Prince Brand
prince itzla arkan|Prince Itzla Arkan
princess astrid|Princesse Astrid
prison pete|Prison Pete
prisoner|Prisonnier
prissy scilla|Prissy Scilla
private paldo|Soldat Paldo
private paldon|Soldat Paldon
private pendron|Soldat Pendron
private pierreb|Soldat Pierreb
probita|Probita
professor gracklebone|Professeur Gracklebone
professor imblewyn|Professeur Imblewyn
professor manglethorp|Professeur Manglethorp
professor oddenstein|Professeur Oddenstein
professor onglewip|Professeur Onglewip
prosecutor|Procureur
prospector percy|Prospecteur Percy
protest leader|Chef des manifestants
protester|Manifestant
psykk bat|Batte Psykk
puffer fish|Poisson-globe
puffin|Macareux
pumpkin|Citrouille
pumpy|Pumpy
punching bag|Sac de frappe
purepker895|Purepker895
purple partyhat|Chapeau de fête violet
purple pewter director|Directeur en étain violet
purple pewter secretary|Secrétaire en étain violet
pusskins|Pusskins
pygmy hippo|Hippopotame pygmée
pygmy hippo calf|Bébé hippopotame pygmée
pygmy kraken|Kraken pygmée
pyramid block|Bloc pyramidal
pyre fox|Renard pyre
pyrefiend|Pyrefiend Levele niveau 43
pyrelord|Pyrelord Levele 1
pyromancer|Pyromancien
quartermaster|Quartier-maître
queen ellamaria|Reine Ellamaria
queen sigrid|Reine Sigrid
queen spawn|Apparition de la reine
queen zyanyi arkan|Reine Zyanyi Arkan
quest guide|Guide des quêtes
quetzal|Quetzal
quetzin|Quetzin
quinton|Quinton
quiz master|Maître du quiz
qutiedoll|Qutiedoll
r0ck 5masher|R0ck 5masher
r2t2pnsh0ty|R2t2pnsh0Ty
r4ng3rno0b889|R4ng3rNo0b889
rabbit|Lapin
rabbit chef|Lapin chef
raccoon|Ratons laveurs
rachael|Rachael
rachel|Rachel
racoon buddy|Copain raton laveur
radat|Radat
radiant sanguisphera|Sanguisphéra radieuse
radigad ponfit|Radigad Ponfit
radimus erkle|Radimus Erkle
radu|Radu
raeli|Raeli
raetul|Raetul
ragnar|Ragnar
ragnvald|Ragnvald
rainbow crab|Crabe arc-en-ciel
rakkar|Rakkar
ram|Ram
ramara du croissant|Ramara du Croissant
ramarno|Ramarno
ramocean|Ramocean
ranael|Ranael
ranalph devere|Ranalph Devere
randivor|Randivor
ranged combat tutor|Tuteur de combat à distance
ranger|Ranger
ranging guild doorman|Portier de la guilde des archers
ranging ro|Ranging Ro
ranis drakan|Ranis Drakan
rannveig|Rannveig
rantz|Rantz
ranulph|Ranulph
raqueel|Raqueel
rascally child|Enfant espiègle
rashiliyia|Rashiliyia
rasolo|Rasolo
rassain|Rassain
rat|Rat
rat burgiss|Rat Burgiss
rauborn|Rauborn
raulyn|Raulyn
raum urda-stein|Raum Urda-Stein
ravager|Ravageur
raven|Corbeau
razmire keelgan|Razmire Keelgan
razvan|Razvan
reanimated abyssal|Abyssal réanimé
reanimated aviansie|Aviansie réanimée
reanimated bear|Ours réanimé
reanimated bloodveld|Bloodveld réanimé
reanimated chaos druid|Druide du chaos réanimé
reanimated dagannoth|Dagannoth réanimé
reanimated demon|Démon réanimé
reanimated demon spawn|Démon réanimé spawn
reanimated dog|Chien réanimé
reanimated dragon|Dragon réanimé
reanimated elf|Elfe réanimé
reanimated giant|Géant réanimé
reanimated goblin|Gobelin réanimé
reanimated hellhound|Chien de l'enfer réanimé
reanimated horror|Horreur réanimée
reanimated imp|Imp réanimé
reanimated kalphite|Kalphite réanimé
reanimated minotaur|Minotaure réanimé
reanimated monkey|Singe réanimé
reanimated ogre|Ogre réanimé
reanimated scorpion|Scorpion réanimé
reanimated troll|Troll réanimé
reanimated tzhaar|TzHaar réanimé
reanimated unicorn|Licorne réanimée
rebecca|Rebecca
rebel archer|Archer rebelle Levele 1
rebel scout|Éclaireur rebelle Levele Lletya
rebel warrior|Guerrier rebelle Levele Femme
receptionist|Réceptionniste
recruiter|Recruteur
red axe cat|Chat à la hache rouge Levele Endormi
red axe director|Directeur Red Axe Levele 1 : Conte oubliable...
red axe secretary|Secrétaire Red Axe
red crab|Crabe rouge
red dragon|Dragon rouge
red fireflies|Lucioles rouges
red h'ween mask|Masque rouge d'Halloween
red monkey|Singe rouge
red panda|Panda roux
red partyhat|Chapeau de fête rouge
red salamander|Salamandre rouge
red sheep|Mouton rouge Levele 1 : Teint
red skink|Scincide rouge
redbeard frank|Frank Barbe-Rouge
redeyes|Yeux rouges
reef snake|Serpent de récif
reese|Reese
reeso|Reeso
ref|Référence Levele 18 lb
refugee|Réfugié Levele 1
regath|Regath
regent|Régent
reggle, master coral farmer|Reggle, maître cultivateur de corail
reginald|Reginald
regulus cento|Regulus Cento Levele Misthalin
reinald|Reinald
reindeer hat|Chapeau de renne
reinn|Reinn
reldak|Reldak
reldo|Reldo
relobo blinyo|Relobo Blinyo
remsai|Remsai
remus kaninus|Remus Kaninus
renata|Renata
renegade knight|Chevalier renégat
rennard|Rennard
renu|Renu
repugnant spectre|Spectre répugnant
researcher|Chercheur
reshi|Reshi
resistance fighter|Combattant de la résistance Levele 1
resonance crystal|Cristal de résonance
respiratory system|Système respiratoire
restless ghost|Fantôme agité
restless goat|Chèvre agitée
retired sailor|Marin à la retraite
revenant cyclops|Cyclope revenant
revenant dark beast|Bête noire revenante
revenant demon|Démon revenant
revenant dragon|Dragon revenant
revenant goblin|Gobelin revenant
revenant hellhound|Chien de l'enfer revenant
revenant hobgoblin|Hobgobelin revenant
revenant imp|Diablotin revenant
revenant knight|Chevalier revenant
revenant maledictus|Maledictus revenant
revenant ork|Ork revenant
revenant pyrefiend|Pyrefiend revenant
rewards guardian|Gardien des récompenses
rhazien|Rhazien
rhiannon|Rhiannon
rhoddwr tan|Rhoddwr Tan
rhonen|Rhonen
rhyfel|Rhyfel
ribs|Ribs
richard|Richard
richard flintmaul|Richard Flintmaul
rick|Rick
rick turpentine|Rick Turpentine
rickety door|Porte branlante
rid|Rid
rift guardian|Gardien de la faille
riki the sculptor's model|Riki, le modèle du sculpteur
rimae sirsalis|Rimae Sirsalis
rind the gardener|Rind, le jardinier
rinder|Rinder
rionasta|Rionasta
ritual circle|Cercle rituel
river troll|Troll des rivières
riyl shade|Riyl Shade
riyl shadow|Ombre de Riyl
roachey|Roachey
roavar|Roavar
robert boss|Robert Boss
robert o'reilly|Robert O'Reilly
robert the strong|Robert le Fort
robin|Robin
robyn|Robyn
rock|Rock
rock crab|Rock Crab
rock golem|Golem de roche
rock lobster|Langouste
rocking chair|Fauteuil à bascule
rockslug|Limace des rochers
rocky|Rocky
rocnar|Rocnar
rod fishing spot|Lieu de pêche à la canne
roger|Roger
rogue|Rogue
rogue guard|Rogue Guard
rohak|Rohak
rokuh|Rokuh
rolad|Rolad
rolayne twickit|Rolayne Twickit
romeo|Romeo
rometti|Rometti
romily weaklax|Romily Weaklax
rommik|Rommik
ron gadderanks|Ron Gadderanks
rooster|Coq
root|Root
rory|Rory
ros|Ros
rosie|Rosie
ross|Ross
ross and ben|Ross et Ben
rowdy dwarf|Nain turbulent Levele Conte oubliable...
rowdy guard|Garde turbulent
rowdy slave|Esclave turbulent
roy|Roy
roy jr.|Roy jr.
royal guard|Garde royale Levele Femme
ru merald|Ru Merald
ruantun|Ruantun
rubber chicken|Poulet en caoutchouc
ruby harvest|Récolte de rubis
rufus|Rufus
rug merchant|Marchand de tapis
rum-dashed ralph|Ralph le rum-dashed
runa|Runa
rune dragon|Dragon runique
runite golem|Golem runique
runite minor|Runite mineur
runite ore|Minerai de runite
runolf|Runolf
runvastr|Runvastr
rupert the beard|Rupert la Barbe
ruptura araxyte|Ruptura Araxyte
rusty|Rusty
saba|Saba
sabeil|Sabeil
saboteur|Saboteur
sabre-toothed kebbit|Kebbit à dents de sabre
sabre-toothed kyatt|Kyatt à dents de sabre
sabreen|Sabreen
sacrifice|Sacrifice
sadie|Sadie
sadwrn|Sadwrn
saeros|Saeros
saeth|Saeth
safalaan hallow|Safalaan Hallow
safta doc|Safta Doc
sagira|Sagira
sailing cat|Chat marin
sailor|Marin
sailor jakob|Marin Jakob Levele 1
sakirth|Sakirth Levele Libéré
salarin the twisted|Salarin le tordu
salenab|Salenab
salgant|Salgant
salius|Salius
salvager|Salvager Levele 1
sam|Sam
samir|Samir
sammy servil|Sammy Servil
san fan|San Fan
san tojalon|San Tojalon
sand crab|Crabe des sables
sand snake|Serpent des sables
sand storm|Tempête de sable
sandicrahb|Sandicrahb
sandwich lady|Femme aux sandwichs
sandy|Sandy
sanfew|Sanfew
sani piliu|Sani Piliu
saniboch|Saniboch
santa|Père Noël
santa claus|Père Noël
santa hat|Bonnet de Père Noël
santa's bodyguard|Garde du corps du Père Noël
santa's scribe|Scribe du Père Noël
santa's throne|Trône du Père Noël
santiri|Santiri
sapphire glacialis|Sapphire glacialis
sarachnis|Sarachnis
saradomin priest|Prêtre de Saradomin
saradomin wizard|Sorcier de Saradomin
saradominist recruiter|Recruteur saradoministe
sarah|Sarah
sarble|Sarble
sarius guile|Sarius Guile
saro|Saro
sas member|Membre du SAS
sassilik|Sassilik
saunders|Saunders
savage bird|Oiseau sauvage
savant|Savant
sawmill operator|Opérateur de scierie
sbott|Sbott
scabaras|Scabaras
scarab|Scarab
scarab mage|Mage scarabée
scarab swarm|Essaim de scarabées
scarabs|Scarabées
scared skavid|Skavid effrayé
scarg|Scarg
scarred black demon|Démon noir balafré
scarred greater demon|Grand démon balafré
scarred hellhound|Chien de l'enfer balafré
scarred imp|Diablotin balafré
scarred lesser demon|Démon mineur balafré
scavenger beast|Bête charognarde
scavenger runt|Charognard chétif
scavvo|Scavvo
schoolboy|Écolier
schoolgirl|Écolière
scion|Scion
scorpia|Scorpia
scorpia's guardian|Gardien de Scorpia
scorpia's offspring|Descendant de Scorpia
scorpion|Scorpion
scorpion spirit|Esprit scorpion
scout|Éclaireur
screaming banshee|Banshee hurlante
screaming twisted banshee|Banshee hurlante déformée
scrubfoot|Scrubfoot
scruffy|Scruffy
scurrius|Scurrius
scurry|Scurry
scythe|Faux
sea hawk|Faucon des mers
sea kraken|Kraken des mers
sea monodon|Monodon marin
sea slug|Limace de mer
sea slugs display|Exposition de limaces de mer
sea snake hatchling|Bébé serpent de mer
sea snake young|Jeune serpent de mer
sea troll|Troll marin
sea troll general|Général troll des mers
sea troll queen|Reine troll des mers
seagull|Mouette
seal|Phoque
seaman lorris|Marin Lorris
seaman morris|Marin Morris
seaman thresnor|Marin Thresnor
sebamo|Sebamo
secretary|Secrétaire
security guard|Agent de sécurité
seddu|Seddu
seer|Voyant
seia, teoki of ranul|Seia, Teoki de Ranul
selena|Selena
selene|Selene
selim|Selim
selina kebbit-monkfish|Selina Kebbit-Monkfish
seravel|Seravel
sergeant|Sergent
sergeant damien|Sergent Damien
sergeant grimspike|Sergent Grimspike
sergeant mossfists|Sergent Mossfists
sergeant raymond|Sergent Raymond
sergeant ricardo|Sergent Ricardo
sergeant sambur|Sergent Sambur
sergeant slimetoes|Sergent Slimetoes
sergeant steelwill|Sergent Steelwill
sergeant strongstack|Sergent Strongstack
sergeant tobyn|Sergent Tobyn
sergiu|Sergiu
sergius|Sergius
serpent shaman|Chaman serpent
servant|Serviteur
servery assistant|Aide de cuisine
servius, teokan of ralos|Servius, Teokan de Ralos
seth|Seth
seth groats|Seth Groats
shade|Ombre
shade spirit|Esprit de l'ombre
shadow|Ombre
shadow hound|Chien de l'ombre
shadow keeper|Gardien de l'ombre
shadow rift|Faille de l'ombre
shadow spider|Araignée de l'ombre
shadow totem|Totem de l'ombre
shadow warrior|Guerrier de l'ombre
shadow wyrm|Wyrm de l'ombre
shadowy figure|Silhouette sombre
shady stranger|Étranger louche
shaeded beast|Bête de l'ombre
shamus|Shamus
shanomi|Shanomi
shantay|Shantay
shantay guard|Garde de Shantay
sharathteerk|Sharathteerk
sharimika|Sharimika
shark|Requin
shas|Shas
shayda|Shayda
shayzien infiltrator|Infiltrateur Shayzien
sheep|Mouton
sheepdog|Chien de berger
shellbane gryphon|Gryphon Shellbane
sherlock|Sherlock
sherpa|Sherpa
sheryl|Sheryl
shield master|Maître du bouclier
shifter|Shifter
shifty looking priest|Prêtre à l'air louche
shilop|Shilop
shipwright|Charpentier de marine
shipwright sally|Charpentier de marine Sally
shipwright sam|Charpentier de marine Sam
shipwright sarah|Charpentier de marine Sarah
shipwright sasha|Charpentier de marine Sasha
shipwright scott|Charpentier de marine Scott
shipwright seb|Charpentier de marine Seb
shipwright sennia|Charpentier de marine Sennia
shipwright seth|Charpentier de marine Seth
shipwright sigrun|Charpentier de marine Sigrun
shipwright silas|Charpentier Silas
shipwright silrien|Charpentier Silrien
shipwright sophie|Charpentier Sophie
shipwright soraya|Charpentier Soraya
shipwright sornik|Charpentier Sornik
shipwright spencer|Charpentier Spencer
shipwright steve|Charpentier Steve
shipwright sylvia|Charpentier Sylvia
shipyard engineer|Ingénieur de chantier naval
shipyard worker|Ouvrier du chantier naval
shiratti the custodian|Shiratti le gardien
shockwave colossus|Colosse Shockwave
shop assistant|Vendeur
shop keeper|Commerçant
shopkeeper|Commerçant
shura|Shura
siamun|Siamun
sian|Sian
sid|Sid
siegfried erkle|Siegfried Erkle
sigbert the adventurer|Sigbert l'aventurier
sigismund|Sigismund
sigli|Sigli
sigli the huntsman|Sigli le chasseur
sigmund|Sigmund
sigmund and zanik|Sigmund et Zanik
sigmund the merchant|Sigmund le marchand
signy|Signy
sigurd|Sigurd
sil'as dahcsnu|Sil'as Dahcsnu
silia|Silia
silif|Silif
silk merchant|Marchand de soie
silk trader|Négociant en soie
silver cog director|Directeur de Silver Cog
silver cog secretary|Secrétaire de Silver Cog
silver merchant|Marchand d'argent
silver ore|Minerai d'argent
simon|Simon
simon templeton|Simon Templeton
simona|Simona
sin seer|Voyante du péché
sinclair guard dog|Chien de garde Sinclair
sinco doar|Sinco Doar
sinister stranger|Étranger sinistre
sir amik varze|Sir Amik Varze
sir bedivere|Sir Bedivere
sir burrus|Sir Burrus
sir carl|Sir Carl
sir gawain|Sir Gawain
sir harry|Sir Harry
sir jerro|Sir Jerro
sir kay|Sir Kay
sir kuam ferentse|Sir Kuam Ferentse
sir lancelot|Sir Lancelot
sir leye|Sir Leye
sir lucan|Sir Lucan
sir mordred|Sir Mordred
sir palomedes|Sir Palomedes
sir pear visor|Sir Pear Visor
sir pelleas|Sir Pelleas
sir percival|Sir Percival
sir prysin|Sir Prysin
sir rebral|Sir Rebral
sir ren itchood|Sir Ren Itchood
sir renitee|Sir Renitee
sir spishyus|Sir Spishyus
sir tiffy cashien|Sir Tiffy Cashien
sir tinley|Sir Tinley
sir tristram|Sir Tristram
sir vyvin|Sir Vyvin
siren|Sirène
sirsal banker|Sirsal Banker
sister aseret|Sœur Aseret
sister naoj|Sœur Naoj
sister salohcin|Sœur Salohcin
sister scarophia|Sœur Scarophia
sister senga|Sœur Senga
sister sevi|Sœur Sevi
sister soul jar|Sœur Soul Jar
sister toen|Sœur Toen
sister yram|Sœur Yram
sithaph|Sithaph
sithik ints|Sithik Ints
skavid|Skavid
skeletal miner|Mineur squelettique
skeletal mystic|Mystique squelettique
skeletal thrall|Esclave squelettique
skeletal wyvern|Wyvern squelettique
skeleton|Squelette
skeleton brute|Squelette brute
skeleton champion|Champion squelette
skeleton fremennik|Squelette fremennik Levele 40
skeleton guard|Squelette garde
skeleton heavy|Squelette lourd
skeleton hellhound|Chien de l'enfer squelette
skeleton hero|Squelette héros
skeleton mage|Mage squelette
skeleton outfit|Tenue de squelette
skeleton thug|Squelette voyou
skeleton warlord|Squelette chef de guerre
skippy|Skippy
skoblin|Skoblin
skogre|Skogre
skotizo|Skotizo
skotos|Skotos
skrach uglogwee|Skrach Uglogwee
skraeling|Skraeling
skulgrimen|Skulgrimen
skuli myrka|Skuli Myrka
skullball|Skullball
skullball boss|Skullball Boss
skullball trainer|Skullball Trainer
skully|Skully
skylark|Skylark
slagilith|Slagilith
slash bash|Slash Bash
slave|Esclave
sleeping monkey|Singe endormi
sleepwalker|Somnambule
sleve mcdichael|Sleve McDichael Levele 1
slieve|Slieve
slim louie|Slim Louie
slippers|Pantoufles
sliske|Sliske tenant une lanterne
sloane|Sloane
slug hemligssen|Limace Hemligssen
slug prince|Prince limace
small lizard|Petit lézard
small ninja monkey|Petit singe ninja
small scarab|Petit scarabée
small zombie monkey|Petit singe zombie
smart-looking dog|Chien intelligent
smellytoes|Smellytoes
smiddi ryak|Smiddi Ryak
smith|Smith
smithing apprentice|Apprenti forgeron
smithing catalyst|Catalyseur de forge
smoggy|Smoggy
smoke devil|Diable de fumée
smoke totem|Totem de fumée
smokedevil|Smokedevil
smokin' joe|Smokin' Joe
smol heredit|Smol heredit
smolcano|Smolcano
snail display|Écrin d'escargot
snailfeet|Pattes d'escargot
snake|Serpent
snake spirit|Esprit serpent
snakeling|Snakeling
sneaky undead fowl|Volaille morte-vivante sournoise
snothead|Snothead
snow|Neige
snowball|Boule de neige
snowball champion|Champion de la boule de neige
snowflake|Flocon de neige
snowman|Bonhomme de neige
snowy knight|Chevalier des neiges
soar leader pitri|Soar Leader Pitri
sofiya|Sofiya
sol heredit|Sol Heredit
soldier|Soldat
soldier scarab|Soldat Scarab
solihib|Solihib
solus dellagar|Solus Dellagar
solztun|Solztun
sonalo|Sonalo
sophanem guard|Garde Sophanem Levele 1
sophia hughes|Sophia Hughes Levele Évadée
sorceress|Sorcière
sorebones|Sorebones Levele Tablier
sorin|Sorin Levele Normal
sorrn|Sorrn
sotetseg|Sotetseg
soulless|Sans âme
soup|Soupe
sourhog|Sourhog
spang|Spang
spawn|Spawn
spawn of sarachnis|Spawn de Sarachnis
spawn sharhai|Spawn sharhai
spectator|Spectateur
speedy keith|Speedy Keith
spencer brentwood|Spencer Brentwood
sphinx|Sphinx
spice merchant|Marchand d'épices
spice seller|Vendeur d'épices
spider|Araignée
spidey dog|Chien araignée
spidine|Spidine
spike|Spike
spiked turoth|Turoth à pointes
spin blades|Lames tournantes
spindel|Spindel
spindel's spiderling|Araignée de Spindel
spined kraken|Kraken à pointes
spined larupia|Larupia à pointes
spinner|Filateur
spinolyp|Spinolyp
spirit angler|Pêcheur spirituel
spirit of scorpius|Esprit de Scorpius
spirit of zadimus|Esprit de Zadimus
spirit pool|Réserve d'esprits
spiritual mage|Mage spirituel
spiritual ranger|Ranger spirituel
spiritual warrior|Guerrier spirituel
spit goblin|Gobelin cracheur
spitting scarab|Scarabée cracheur
spitting wyvern|Wyvern cracheur
splatter|Éclaboussure
spooky chair|Chaise effrayante
spooky dog|Chien effrayant
spotted kebbit|Kebbit tacheté
spotted rae|Rae tacheté
spotter virginia|Spotter Virginia
spria|Spria
spring elemental|Élémentaire du printemps
squire|Écuyer
squirrel|Écureuil
squirrel friend|Ami écureuil
squirrel monkey|Singe écureuil
sraracha|Sraracha
stag|Cerf
stanford|Stanford
stankers|Stankers
star sprite|Star Sprite
starflower|Starflower
starlight|Starlight
starved horror|Horreur affamée
steel dragon|Dragon d'acier
steve|Steve
stick|Bâton
stingray|Raie
stone guardian|Gardien de pierre
stonemason|Maçon
stool|Tabouret
storm cloud|Nuage d'orage
stradius|Stradius
strange bush|Buisson étrange
strange creature|Créature étrange
strange device|Appareil étrange
strange old man|Vieil homme étrange
strange plant|Plante étrange
strange watcher|Observateur étrange
stranger|Étranger
strangled|Étranglé
strangled bear|Ours étranglé
strangled boar|Sanglier étranglé
strangled lynx|Lynx étranglé
straven|Straven
stray dog|Chien errant
street urchin|Gamin des rues
strisath|Strisath
strolgrum|Strolgrum
strong barrier|Barrière solide
strong catalytic guardian|Gardien catalytique solide
strong elemental guardian|Gardien élémentaire solide
strong ronny|Ronny solide
strong warrior|Guerrier solide
strong winds|Vents violents
strongbones|Strongbones
student|Étudiant
stuliette|Stuliette
stumpy|Stumpy
stunted demonic gorilla|Gorille démoniaque rabougri
styrmir|Styrmir
sue|Sue
suit of armour|Armure
sulisal|Sulisal
sulphur lizard|Lézard sulfureux
sulphur nagua|Nagua sulfureux
summer elemental|Élémentaire d'été
summoned soul|Âme invoquée
summoned zombie|Zombie invoqué
sunbeam skink|Scincidé de soleil
sune|Sune
sunlight antelope|Antilope de lumière
sunlight moth|Papillon de lumière
superior ghostly thrall|Esclave fantomatique supérieur
superior skeletal thrall|Esclave squelettique supérieur
superior zombified thrall|Esclave zombifié supérieur
supervisor lalo|Superviseur Lalo
supporting pillar|Pilier de soutien
supreme commander|Commandant suprême
suqah|Suqah
surgeon general tafani|Chirurgien général Tafani
surma|Surma
surok magis|Surok Magis
survival expert|Expert en survie Levele 2020 Tutoriel
suspect|Suspect Levele 1
suspicious crate|Caisse suspecte
suspicious outsider|Étranger suspect
suspicious shell|Coquille suspecte
suzie|Suzie
svetlana|Svetlana
svidi|Svidi
swamp crab|Crabe des marais Levele 139
swamp creature|Créature des marais
swamp frog|Grenouille des marais
swamp lizard|Lézard des marais
swamp priest|Prêtre des marais
swamp snake|Serpent des marais
swamp toad|Crapaud des marais Levele 139
swan|Cygne
swarm|Essaim
sweeper|Balayeur
swensen the navigator|Swensen le Navigateur
swordchick|Swordchick
sylas|Sylas
sylvia|Sylvia
taala|Taala
tabbitha|Tabbitha
tail|Queue
taiman|Taiman
talia|Talia
taloned wyvern|Wyvern à griffes
tamayu|Tamayu
tamble|Tamble
tanglefoot|Tanglefoot
tangleroot|Tangleroot
tanner|Tanner
tanya|Tanya
tapir|Tapir
tapir calf|Bébé tapir
tar monster|Monstre de goudron
tarfol quo maten|Tarfol quo Maten
target|Cible
taria|Taria
tarik|Tarik
tarn|Tarn
tarquin|Tarquin
tassie slipcast|Tassie Slipcast
tati|Tati
tatie|Tatie
tau|Tau
taxidermist|Taxidermiste
taylor|Taylor
tayten|Tayten
taz|Taz
tea seller|Tea Seller
teacher and pupil|Enseignant et élève
techichi|Techichi
tecu salamander|Tecu salamander
ted rehnison|Ted Rehnison
tegdak|Tegdak
tegid|Tegid
teicuh|Teicuh
tekton|Tekton
telekinetic guardian|Gardien télékinésique
temple guardian|Gardien du temple
temple spider|Araignée du temple
tempoross|Tempoross
tenoch|Tenoch
tentacle|Tentacule
tenzing|Tenzing
teodor|Teodor
tern|Sterne
terror dog|Chien terrifiant
terror dog statue|Statue de chien terrifiant
terrorbird|Oiseau terrifiant
terrorbird display|Exposition oiseau terrifiant
terrorbird guard 21|Garde oiseau terrifiant 21
terrorbird guard 72|Garde oiseau terrifiant 72
terrorchick gnome|Gnome oiseau de terreur
terry balando|Terry Balando
tetra|Tetra
teumo|Teumo
thaerisk|Thaerisk Levele Début de quête
thakkrad sigmundson|Thakkrad Sigmundson Levele Cinématique
the 'wedge'|Le « Coin »
the beast|La Bête
the collector|Le Collectionneur
the disappointing gelt|Le Gelt décevant
the draugen|Le Draugen
the everlasting|L'Éternel
the face|Le Visage
the fisher king|Le Roi pêcheur
the forsaken assassin|L'Assassin abandonné
the great guardian|Le Grand Gardien
the hueycoatl|Le Hueycoatl
the illusive|L'Illusoire
the inadequacy|L'Inadéquation
the jormungand|Le Jormungand
the kendal|Le Kendal
the lady of the lake|La Dame du lac
the leviathan|Le Léviathan
the leviathan?|Le Léviathan ?
the maiden of sugadinti|La Jeune fille de Sugadinti
the mimic|Le mime
the monkey's aunt|La tante du singe
the monkey's uncle|L'oncle du singe
the mouth of clarence|La bouche de Clarence
the nightmare|Le cauchemar
the rocks|Les rochers
the sage|Le sage
the shaikahan|Le Shaikahan
the untouchable|L'Intouchable
the whisperer|Le Chuchoteur
theodore paxton|Théodore Paxton
thermonuclear smoke devil|Diable de fumée thermonucléaire
thessalia|Thessalia
thias leacke|Thias Leacke
thidrolda|Thidrolda
thief|Voleur
thigo|Thigo
thing under the bed|Chose sous le lit
thingol|Thingol
third age mage|Mage du Troisième Âge
third age ranger|Ranger du Troisième Âge
third age warrior|Guerrier du Troisième Âge
thirus|Thirus
thistle|Chardon
thomas|Thomas
thomdril|Thomdril
thora|Thora
thora the barkeep|Thora la barmaid
thordur|Thordur
thorgel|Thorgel
thorhild|Thorhild
thorkel silkbeard|Thorkel Silkbeard
thormac|Thormac
thorodin|Thorodin
thorvald|Thorvald
thorvald the warrior|Thorvald le guerrier
thrander|Thrander
thrantax the mighty|Thrantax le Puissant
thrower troll|Troll lanceur
thug|Voyou
thumpy|Thumpy
thurgo|Thurgo
thurid|Thurid
thyria|Thyria
tiadeche|Tiadeche
ticket dwarf|Nain vendeur de billets
ticket goblin|Gobelin vendeur de billets
ticket merchant|Marchand de billets
tide|Marée
tiger shark|Requin tigre
tiles|Carreaux
tilt|Tilt
tim|Tim
timallus|Timallus
timble|Timble
timfraku|Timfraku
tin ore|Minerai d'étain
tina|Tina
tindar|Tindar
tindel marchant|Marchand Tindel
tinsay|Tinsay
tinse torpe|Tinse Torpe
tiny tempor|Petit tempor
tirrie|Tirrie
tizoro|Tizoro
tjorvi|Tjorvi
toban|Toban
toby|Toby
toch|Toch
toci|Toci
tok-xil|Tok-Xil
tolna|Tolna
tom|Tom
tomas lawry|Tomas Lawry
tombar|Tombar
tommy 2-times|Tommy 2 fois
tonali archer|Tonali Archer
tonali warrior|Tonali Warrior
tool leprechaun|Tool Leprechaun
toothy|Toothy
topsy|Topsy
torag the corrupted|Torag le Corrompu
torbrund|Torbrund
torcher|Torcher
torfinn|Torfinn
tormented demon|Démon tourmenté Levele 1
tormented soul|Âme tourmentée
tormented warrior|Guerrier tourmenté
tornado|Tornade
torrcs|Torrcs
torrell|Torrell
tortoise|Tortue
tortured gorilla|Gorille torturé
tortured soul|Âme torturée
tostig|Tostig
totem|Totem
toucan|Toucan
tough guy|Dur à cuire
tourist|Touriste
tower advisor|Conseiller de la tour
tower archer|Archer de la tour
tower guard|Garde de la tour
tower mage|Mage de la tour
town crier|Crieur public
town guard|Garde municipal Levele 1 à barbe orange
toy cat|Chat jouet
tracker gnome 1|Gnome traqueur Levele 1
tracker gnome 2|Gnome traqueur Levele 2
tracker gnome 3|Gnome traqueur Levele 3
trade referee|Arbitre commercial
trader|Marchand
trader crewmember|Membre d'équipage marchand
trader stan|Marchand Stan
trader sven|Marchand Sven
tragacanth|Tragacanthe
trainee guard|Garde stagiaire Levele 1
trainer nacklepen|Entraîneur Nacklepen
tramp|Vagabond
trapped soul|Trapped Soul
traxi|Traxi
treacle|Treacle
treasure fairy|Fée du trésor
tree spirit|Esprit des arbres
trefaji|Trefaji
treus dayth|Treus Dayth
treznor|Treznor
tribal weapon salesman|Vendeur d'armes tribales
tribesman|Membre de la tribu
tribeswoman|Membre de la tribu
tristan|Tristan
trobert|Trobert
trogen konungarde|Trogen Konungarde
troll|Troll
troll child|Enfant troll
troll father|Père troll
troll general|Général troll
troll mother|Mère troll
troll spectator|Spectateur troll
trolley|Chariot
tropical wagtail|Bergeronnette tropicale
trossa|Trossa
trotters|Trotters
trufitus|Trufitus
tstanon karlak|Tstanon Karlak
tsunami|Tsunami
tumeken's guardian|Gardien de Tumeken
tumeken's warden|Gardien de Tumeken
turael|Turael
turbogroomer|Turbogroomer
turgall|Turgall
turgok|Turgok
turgon|Turgon
turkey|Dinde
turoth|Turoth
tutab|Tutab
twig|Twig
twiggy o'korn|Twiggy O'Korn
twisted banshee|Twisted Banshee
two-pints|Two-pints
tyke|Tyke
tynan|Tynan
typhor|Typhor
tyras guard|Garde Tyras
tyss|Tyss
tz-kek|Tz-Kek
tz-kih|Tz-Kih
tzatelli|Tzatelli
tzhaar-hur|TzHaar-Hur
tzhaar-hur-lek|TzHaar-Hur-Lek
tzhaar-hur-rin|TzHaar-Hur-Rin
tzhaar-hur-tel|TzHaar-Hur-Tel
tzhaar-hur-zal|TzHaar-Hur-Zal
tzhaar-ket|TzHaar-Ket
tzhaar-ket-keh|TzHaar-Ket-Keh
tzhaar-ket-rak|TzHaar-Ket-Rak
tzhaar-ket-yil|TzHaar-Ket-Yil
tzhaar-ket-zuh|TzHaar-Ket-Zuh
tzhaar-mej|TzHaar-Mej
tzhaar-mej-bal|TzHaar-Mej-Bal
tzhaar-mej-dir|TzHaar-Mej-Dir
tzhaar-mej-jal|TzHaar-Mej-Jal
tzhaar-mej-kah|TzHaar-Mej-Kah
tzhaar-mej-roh|TzHaar-Mej-Roh
tzhaar-xil|TzHaar-Xil
tziuhtla|Tziuhtla
tzkal-zuk|TzKal-Zuk
tzrek-jad|Tzrek-jad
tztok-jad|TzTok-Jad
ueman, teoki of ralos|Ueman, Teoki de Ralos
ug|Ug
uglug nar|Uglug Nar
ugthanki|Ugthanki
ulfric|Ulfric
ulifed|Ulifed
ulina|Ulina
ulizius|Ulizius
ulsquire shauncy|Ulsquire Shauncy
umbra|Umbra
unbound jaltok-jad|Unbound JalTok-Jad
undead chicken|Poulet mort-vivant
undead combat dummy|Mannequin d'entraînement mort-vivant
undead cow|Vache mort-vivante
undead druid|Undead Druid
undead hero|Undead Hero
undead lumberjack|Undead Lumberjack
undead mage|Mage mort-vivant
undead one|Mort-vivant
undead tree|Arbre mort-vivant
undead zealot|Zélote mort-vivant
underwater horror|Horreur sous-marine
undor|Undor
unferth|Unferth Levele 1
unfinished beehive|Ruche inachevée
ungadulu|Ungadulu
unicorn|Licorne
unicorn foal|Poulain licorne
unicorn1337kilr|Licorne1337Kilr
unicow|Licorne
unstable ice|Glace instable
unstable orb|Orbe instable
unusual chicken|Poulet inhabituel
uodai|Uodai
upset easter egg hunter|Chasseur d'œufs de Pâques contrarié
ur-lun|Ur-lun
ur-meg|Ur-meg
ur-pel|Ur-pel
ur-taal|Ur-taal
ur-tag|Ur-tag
ur-vass|Ur-vass
ur-zek|Ur-zek
urbi|Urbi
uri|Uri
urium shade|Ombre d'Urium
usi|Usi
utrec|Utrec
uurrak quo narga|Uurrak quo Narga
uwogo|Uwogo
uyoro|Uyoro
v|V
vaeringk|Vaeringk
vaire|Vaire
valaine|Valaine
valantay eppel|Valantay Eppel
valdez|Valdez
valentin rasputin|Valentin Rasputin
valentina diaemus|Valentina Diaemus
valeria|Valeria
valgerd|Valgerd
vallessia dracyula|Vallessia Dracyula
vallessia von pitt|Vallessia von Pitt
vampyre juvenile|Vampyre juvénile
vampyre juvinate|Vampyre juvénile
vampyre kraken|Vampyre kraken
vampyressa van von|Vampyressa van Von
vampyric hound|Chien vampirique
vampyrus diaemus|Vampyrus Diaemus
vanescula drakan|Vanescula Drakan
vanessa|Vanessa
vanguard|Avant-garde
vanligga gastfrihet|Vanligga Gastfrihet
vannah|Vannah
vannaka|Vannaka
vanstrom klause|Vanstrom Klause
vardorvis|Vardorvis
vardorvis' head|La tête de Vardorvis
varrian sobak|Varrian Sobak
vasa nistirio|Vasa Nistirio
vasile|Vasile
vasquen|Vasquen
vefari|Vefari
veliaf hurtz|Veliaf Hurtz
velorina|Velorina
velrak the explorer|Velrak l'explorateur
venenatis|Venenatis
venenatis spiderling|Araignée de Venenatis
venenatis' spiderling|Araignée de Venenatis
veos|Veos
vera|Vera
verac the defiled|Verac le souillé
verak|Verak
vermundi|Vermundi
veronica|Veronica
vertida sefalatis|Vertida Sefalatis
verzik vitur|Verzik Vitur
vespine soldier|Soldat vespine
vespula|Vespula
vestri|Vestri
vet'ion|Vet'ion
vet'ion jr.|Vet'ion jr.
victor|Victor
victoria kebbit-monkfish|Victoria Kebbit-Monkfish
viero|Viero
viggora|Viggora
vigr|Vigr
vigroy|Vigroy
viking|Viking
viking woman|Femme viking
villa guard|Garde de villa
villager|Villageois
villia|Villia
vincens|Vincens
vineyard foreman|Contremaître de vignoble
vineyard worker|Ouvrier de vignoble
violetta sanguine|Violetta Sanguine
virilis|Virilis
vitreous chilled jelly|Gelée vitreuse glacée
vitreous jelly|Gelée vitreuse
vitreous warped jelly|Gelée vitreuse déformée
viyeldi|Viyeldi
vlad bechstein|Vlad Bechstein
vlad diaemus|Vlad Diaemus
vladimir|Vladimir
voice of yama|Voix de Yama
void flare|Éclair du vide
void knight|Chevalier du Vide
volatile baboon|Babouin volatil
volatile earth|Terre volatile
volf olafson|Volf Olafson
von van von|Von van Von
vonnetta varnis|Vonnetta Varnis
vorbio|Vorbio
vorkath|Vorkath
vorki|Vorki
vormar vakan|Vormar Vakan
vornas quo maten|Vornas quo Maten
vortas quo keran|Vortas quo Keran
vritra|Vritra
vulcan orvoros|Vulcan Orvoros
vulture|Vautour
vyre orator|Oratrice Vyre
vyrelady|Vyrelady
vyrelord|Vyrelord
vyrewatch|Vyrewatch
vyrewatch sentinel|Vyrewatch Sentinel
wagchin|Wagchin
waiter|Serveur
wall beast|Bête des murs
wallasalki|Wallasalki
wally|Wally
wanderer|Vagabond
wandering guard|Garde errant
wandering impling|Impling errant
war ship|Navire de guerre
warden|Gardien
warmhandz|Warmhandz
warped jelly|Gelée déformée
warped terrorbird|Oiseau terrifiant déformé
warped tortoise|Tortue déformée
warrior|Guerrier
warrior of murahs|Guerrier de Murahs
watchman|Gardien
watchtower wizard|Tour de guet Sorcier
water elemental|Élémentaire d'eau
water spell|Sort d'eau
water wizard|Sorcier de l'eau
waterfiend|Démon de l'eau
watson|Watson
wave|Vague
waydar|Waydar
waymottin|Waymottin
wayne|Wayne
weak barrier|Barrière faible
weak catalytic guardian|Gardien catalytique faible
weak elemental guardian|Gardien élémentaire faible
wealthy citizen|Citoyen riche Levele 1
weaponsmaster|Maître d'armes
weast side49|Côté ouest 49
weave|Tissage
web|Toile
weird old man|Vieil homme étrange
well-armed foe|Ennemi bien armé
well-dressed man|Homme bien habillé
wemund|Wemund
wengra quo sihar|Wengra quo Sihar
werewolf|Loup-garou
wesley|Wesley
weve|Weve
whale|Baleine
wheeler|Wheeler
whirlpool|Tourbillon
white chisel director|Directeur White Chisel
white chisel secretary|Secrétaire White Chisel
white golem|Golem blanc
white jaguar|Jaguar blanc
white knight|Chevalier blanc
white partyhat|Chapeau de fête blanc
white wolf|Loup blanc
wholoucindy57|WhoLouCindy57
wighted leech|Sangsue hantée
wild beehive|Ruche sauvage
wild broav|Broav sauvage
wild dog|Chien sauvage
wild kebbit|Kebbit sauvage
wilf|Wilf
will|Will
will o' the wisp|Feu follet
william|William
willow|Saule
wilough|Wilough
wilson|Wilson
wily cat|Chat rusé
wind spell|Sortilège du vent
winelda|Winelda
wingman skree|Wingman Skree
wingstone|Wingstone
winkin|Winkin
winter elemental|Élémentaire hivernal
winter soldier|Soldat hivernal
wintertoad|Crapaud hivernal
wintumber tree|Arbre Wintumber
wise old man|Vieil homme sage
wiskit|Wiskit
wisp|Wisp
wistan|Wistan
witch|Sorcière
witch's cat|Chat de la sorcière
witch's experiment|Expérience de la sorcière
witchaven villager|Villageois de Witchaven
wizard|Sorcier
wizard akutha|Sorcier Akutha
wizard cromperty|Sorcier Cromperty après le journal intime
wizard distentor|Sorcier Distentor
wizard frumscone|Sorcier Frumscone
wizard grayzag|Sorcier Grayzag
wizard jalarast|Sorcier Jalarast
wizard mizgog|Sorcier Mizgog
wizard persten|Sorcier Persten
wizard sinina|Sorcier Sinina
wizard traiborn|Sorcier Traiborn
wizguard|Wizguard
wolf|Loup
wolfbone|Os de loup
wolfman|Homme-loup
wolfwoman|Femme-loup
woman|Femme
woman-at-arms|Femme soldat
wood dryad|Dryade des bois
woodcutting leprechaun|Lutin bûcheron
woodsman tutor|Tuteur bûcheron
woofson|Woofson
worker|Ouvrier
workman|Ouvrier
worm tongue|Langue de ver
wormbrain|Cerveau de ver
wounded soldier|Soldat blessé
wurbel|Wurbel
wuss|Wuss
wwf conservationist|Conservationniste WWF
wydin|Wydin
wyrm|Wyrm
wyrmling|Wyrmling
wyson the gardener|Wyson le jardinier
wyvern display|Affichage Wyvern
xamphur|Xamphur
xarpus|Xarpus
xi plzpetdogz xix|Xi plzPetDogz xiX
xilo|Xilo
xochitl|Xochitl
xocotla|Xocotla
xolo|Xolo
xopanatl, teoki of ralos|Xopanatl, Teoki de Ralos
xorrah quo sihar|Xorrah quo Sihar
yadech strongarm|Yadech Strongarm
yadviga|Yadviga
yak|Yak
yama|Yama
yami|Yami
yanes|Yanes
yann the unlucky|Yann le malchanceux
yanni salika|Yanni Salika
yarnio|Yarnio
yarsul|Yarsul
yeldive|Yeldive
yellow fortune director|Directeur de la fortune jaune
yellow fortune secretary|Secrétaire de la fortune jaune
yellow partyhat|Chapeau de fête jaune
yellow sheep|Mouton jaune
yellow snow|Neige jaune
yenrab|Yenrab
yeti|Yéti
yewnock the engineer|Yewnock l'ingénieur
ymladd|Ymladd
yo-yo|Yo-yo
yohnus|Yohnus
yolotli, teoki of ralos|Yolotli, Teoki de Ralos
young 'un|Jeune
young impling|Jeune impling
youngllef|Youngllef
yrsa|Yrsa
ysbeid|Ysbeid
ysgawyn|Ysgawyn
ystwyth|Ystwyth
yt-hurkot|Yt-HurKot
yt-mejkot|Yt-MejKot
yulf squecks|Yulf Squecks
yuri|Yuri
yusuf|Yusuf
zaff|Zaff
zahra|Zahra
zahur|Zahur
zahwa|Zahwa
zakl'n gritch|Zakl'n Gritch
zalcano|Zalcano
zamorak crafter|Artisan de Zamorak
zamorak mage|Mage de Zamorak
zamorak ranger|Ranger de Zamorak
zamorak warrior|Guerrier de Zamorak
zamorak wizard|Sorcier de Zamorak
zamorakian acolyte|Acolyte de Zamorak
zamorakian recruiter|Recruteur de Zamorak
zanaris choir|Chœur de Zanaris
zandar horfyre|Zandar Horfyre
zanik|Zanik
zapper|Zapper
zaros|Zaros
zavistic rarve|Zavistic Rarve
zealot|Zélote
zebak|Zebak
zebak's phantom|Fantôme de Zebak
zebak's tail|Queue de Zebak
zeke|Zeke
zembo|Zembo
zemouregal|Zemouregal
zenesha|Zenesha
zenkog|Zenkog
ziggy|Ziggy
zimberfizz|Zimberfizz
zogre|Zogre
zoja|Zoja
zombie|Zombie
zombie head|Tête de zombie
zombie monk|Moine zombie
zombie pirate|Pirate zombie
zombie protester|Manifestant zombie Levele 1
zombie rat|Rat zombie Levele 1
zombie swab|Mouchoir zombie Levele 1
zombie thrall|Zombie Thrall
zombies champion|Champion des zombies
zombified spawn|Zombifié Spawn
zoo keeper|Gardien du zoo
zooknock|Zooknock
zorgoth|Zorgoth
zul-aniel|Zul-Aniel
zul-areth|Zul-Areth
zul-cheray|Zul-Cheray
zul-gutusolly|Zul-Gutusolly
zul-onan|Zul-Onan
zul-urgish|Zul-Urgish
zulrah|Zulrah
zuma|Zuma
zygomite|Zygomite